!!SBtab TableName='Reaction' TableType='Reaction' Document='Model' SBtabVersion='0.9'			
!ID	!ReactionFormula	!Name	!IsReversible
_3HAD100	_3hdecACP_c_ <=> h2o_c_ + tdec2eACP_c_	 3-hydroxyacyl-[acyl-carrier-protein] dehydratase (n-C10:0)	False
_3HAD120	_3hddecACP_c_ <=> h2o_c_ + tddec2eACP_c_	 3-hydroxyacyl-[acyl-carrier-protein] dehydratase (n-C12:0)	False
_3HAD121	_3hcddec5eACP_c_ <=> h2o_c_ + t3c5ddeceACP_c_	 3-hydroxyacyl-[acyl-carrier-protein] dehydratase (n-C12:1)	False
_3HAD140	_3hmrsACP_c_ <=> h2o_c_ + tmrs2eACP_c_	 3-hydroxyacyl-[acyl-carrier-protein] dehydratase (n-C14:0)	False
_3HAD141	_3hcmrs7eACP_c_ <=> h2o_c_ + t3c7mrseACP_c_	 3-hydroxyacyl-[acyl-carrier-protein] dehydratase (n-C14:1)	False
_3HAD160	_3hpalmACP_c_ <=> h2o_c_ + tpalm2eACP_c_	 3-hydroxyacyl-[acyl-carrier-protein] dehydratase (n-C16:0)	False
_3HAD161	_3hcpalm9eACP_c_ <=> h2o_c_ + t3c9palmeACP_c_	 3-hydroxyacyl-[acyl-carrier-protein] dehydratase (n-C16:1)	False
_3HAD40	_3haACP_c_ <=> but2eACP_c_ + h2o_c_	 3-hydroxyacyl-[acyl-carrier-protein] dehydratase (n-C4:0)	False
_3HAD60	_3hhexACP_c_ <=> h2o_c_ + thex2eACP_c_	 3-hydroxyacyl-[acyl-carrier-protein] dehydratase (n-C6:0)	False
_3HAD80	_3hoctACP_c_ <=> h2o_c_ + toct2eACP_c_	 3-hydroxyacyl-[acyl-carrier-protein] dehydratase (n-C8:0)	False
_3OAR100	_3odecACP_c_ + h_c_ + nadph_c_ <=> _3hdecACP_c_ + nadp_c_	 3-oxoacyl-[acyl-carrier-protein] reductase (n-C10:0)	True
_3OAR120	_3oddecACP_c_ + h_c_ + nadph_c_ <=> _3hddecACP_c_ + nadp_c_	 3-oxoacyl-[acyl-carrier-protein] reductase (n-C12:0)	True
_3OAR121	_3ocddec5eACP_c_ + h_c_ + nadph_c_ <=> _3hcddec5eACP_c_ + nadp_c_	 3-oxoacyl-[acyl-carrier-protein] reductase (n-C12:1)	False
_3OAR140	_3omrsACP_c_ + h_c_ + nadph_c_ <=> _3hmrsACP_c_ + nadp_c_	 3-oxoacyl-[acyl-carrier-protein] reductase (n-C14:0)	True
_3OAR141	_3ocmrs7eACP_c_ + h_c_ + nadph_c_ <=> _3hcmrs7eACP_c_ + nadp_c_	 3-oxoacyl-[acyl-carrier-protein] reductase (n-C14:1)	False
_3OAR160	_3opalmACP_c_ + h_c_ + nadph_c_ <=> _3hpalmACP_c_ + nadp_c_	 3-oxoacyl-[acyl-carrier-protein] reductase (n-C16:0)	True
_3OAR161	_3ocpalm9eACP_c_ + h_c_ + nadph_c_ <=> _3hcpalm9eACP_c_ + nadp_c_	 3-oxoacyl-[acyl-carrier-protein] reductase (n-C16:1)	False
_3OAR40	actACP_c_ + h_c_ + nadph_c_ <=> _3haACP_c_ + nadp_c_	 3-oxoacyl-[acyl-carrier-protein] reductase (n-C4:0)	True
_3OAR60	_3ohexACP_c_ + h_c_ + nadph_c_ <=> _3hhexACP_c_ + nadp_c_	 3-oxoacyl-[acyl-carrier-protein] reductase (n-C6:0)	True
_3OAR80	_3ooctACP_c_ + h_c_ + nadph_c_ <=> _3hoctACP_c_ + nadp_c_	 3-oxoacyl-[acyl-carrier-protein] reductase (n-C8:0)	True
_3OAS100	h_c_ + malACP_c_ + ocACP_c_ <=> _3odecACP_c_ + ACP_c_ + co2_c_	 3-oxoacyl-[acyl-carrier-protein] synthase (n-C10:0)	False
_3OAS120	dcaACP_c_ + h_c_ + malACP_c_ <=> _3oddecACP_c_ + ACP_c_ + co2_c_	 3-oxoacyl-[acyl-carrier-protein] synthase (n-C12:0)	False
_3OAS121	cdec3eACP_c_ + h_c_ + malACP_c_ <=> _3ocddec5eACP_c_ + ACP_c_ + co2_c_	 3-oxoacyl-[acyl-carrier-protein] synthase (n-C12:1)	False
_3OAS140	ddcaACP_c_ + h_c_ + malACP_c_ <=> _3omrsACP_c_ + ACP_c_ + co2_c_	 3-oxoacyl-[acyl-carrier-protein] synthase (n-C14:0)	False
_3OAS141	cddec5eACP_c_ + h_c_ + malACP_c_ <=> _3ocmrs7eACP_c_ + ACP_c_ + co2_c_	 3-oxoacyl-[acyl-carrier-protein] synthase (n-C14:1)	False
_3OAS160	h_c_ + malACP_c_ + myrsACP_c_ <=> _3opalmACP_c_ + ACP_c_ + co2_c_	 3-oxoacyl-[acyl-carrier-protein] synthase (n-C16:0)	False
_3OAS161	h_c_ + malACP_c_ + tdeACP_c_ <=> _3ocpalm9eACP_c_ + ACP_c_ + co2_c_	 3-oxoacyl-[acyl-carrier-protein] synthase (n-C16:1)	False
_3OAS60	butACP_c_ + h_c_ + malACP_c_ <=> _3ohexACP_c_ + ACP_c_ + co2_c_	 3-oxoacyl-[acyl-carrier-protein] synthase (n-C6:0)	False
_3OAS80	h_c_ + hexACP_c_ + malACP_c_ <=> _3ooctACP_c_ + ACP_c_ + co2_c_	 3-oxoacyl-[acyl-carrier-protein] synthase (n-C8:0)	False
_3PEPTabcpp	LalaDgluMdap_p_ + atp_c_ + h2o_c_ <=> LalaDgluMdap_c_ + adp_c_ + h_c_ + pi_c_	tripeptide (LalaDgluMdap) transport via ABC system (periplasm)	False
_5DGLCNR	_5dglcn_c_ + h_c_ + nadph_c_ <=> glcn_c_ + nadp_c_	 5-dehydro-D-gluconate reductase	True
_5DOAN	dad_5_c_ + h2o_c_ <=> _5drib_c_ + ade_c_	 5'-deoxyadenosine nuclosidase	False
A5PISO	ru5p_D_c_ <=> ara5p_c_	arabinose-5-phosphate isomerase	True
ACACT1r	2 accoa_c_ <=> aacoa_c_ + coa_c_	acetyl-CoA C-acetyltransferase	True
ACALD	acald_c_ + coa_c_ + nad_c_ <=> accoa_c_ + h_c_ + nadh_c_	acetaldehyde dehydrogenase (acetylating)	True
ACALDtex	acald_e_ <=> acald_p_	acetaldehyde transport via diffusion (extracellular to periplasm)	True
ACALDtpp	acald_p_ <=> acald_c_	acetaldehyde reversible transport (periplasm)	True
ACCOAC	accoa_c_ + atp_c_ + hco3_c_ <=> adp_c_ + h_c_ + malcoa_c_ + pi_c_	acetyl-CoA carboxylase	False
ACGAMK	acgam_c_ + atp_c_ <=> acgam6p_c_ + adp_c_ + h_c_	N-acetylglucosamine kinase	False
ACGK	acglu_c_ + atp_c_ <=> acg5p_c_ + adp_c_	acetylglutamate kinase	False
ACGS	accoa_c_ + glu_L_c_ <=> acglu_c_ + coa_c_ + h_c_	N-acetylglutamate synthase	False
ACHBS	_2obut_c_ + h_c_ + pyr_c_ <=> _2ahbut_c_ + co2_c_	 2-aceto-2-hydroxybutanoate synthase	False
ACKr	ac_c_ + atp_c_ <=> actp_c_ + adp_c_	acetate kinase	True
ACLS	h_c_ + 2 pyr_c_ <=> alac_S_c_ + co2_c_	acetolactate synthase	False
ACM6PH	acmum6p_c_ + h2o_c_ <=> acgam6p_c_ + lac_D_c_	N-acetylmuramate 6-phosphate hydrolase	False
ACOAD1f	btcoa_c_ + fad_c_ <=> b2coa_c_ + fadh2_c_	acyl-CoA dehydrogenase (butanoyl-CoA)	True
ACOAD2f	fad_c_ + hxcoa_c_ <=> fadh2_c_ + hx2coa_c_	acyl-CoA dehydrogenase (hexanoyl-CoA)	True
ACOAD3f	fad_c_ + occoa_c_ <=> fadh2_c_ + oc2coa_c_	acyl-CoA dehydrogenase (octanoyl-CoA)	True
ACOAD4f	dcacoa_c_ + fad_c_ <=> dc2coa_c_ + fadh2_c_	acyl-CoA dehydrogenase (decanoyl-CoA)	True
ACOAD5f	ddcacoa_c_ + fad_c_ <=> dd2coa_c_ + fadh2_c_	acyl-CoA dehydrogenase (dodecanoyl-CoA)	True
ACODA	acorn_c_ + h2o_c_ <=> ac_c_ + orn_c_	acetylornithine deacetylase	False
ACOLIPAtex	acolipa_p_ <=> acolipa_e_	arabinose modified core oligosaccharide lipid A transport via vector (periplasm to extracellular)	False
ACONTa	cit_c_ <=> acon_C_c_ + h2o_c_	aconitase (half-reaction A, Citrate hydro-lyase)	True
ACONTb	acon_C_c_ + h2o_c_ <=> icit_c_	aconitase (half-reaction B, Isocitrate hydro-lyase)	True
ACOTA	acorn_c_ + akg_c_ <=> acg5sa_c_ + glu_L_c_	acetylornithine transaminase	True
ACS	ac_c_ + atp_c_ + coa_c_ <=> accoa_c_ + amp_c_ + ppi_c_	acetyl-CoA synthetase	False
ACt2rpp	ac_p_ + h_p_ <=> ac_c_ + h_c_	acetate reversible transport via proton symport (periplasm)	True
ACt4pp	ac_p_ + na1_p_ <=> ac_c_ + na1_c_	Na+/Acetate symport (periplasm)	False
ACtex	ac_e_ <=> ac_p_	Acetate transport via diffusion (extracellular to periplasm)	True
ADCL	_4adcho_c_ <=> _4abz_c_ + h_c_ + pyr_c_	 4-aminobenzoate synthase	False
ADCS	chor_c_ + gln_L_c_ <=> _4adcho_c_ + glu_L_c_	 4-amino-4-deoxychorismate synthase	False
ADK1	amp_c_ + atp_c_ <=> 2 adp_c_	adenylate kinase	True
ADK4	amp_c_ + itp_c_ <=> adp_c_ + idp_c_	adentylate kinase (ITP)	True
ADNCYC	atp_c_ <=> camp_c_ + ppi_c_	adenylate cyclase	False
ADNK1	adn_c_ + atp_c_ <=> adp_c_ + amp_c_ + h_c_	adenosine kinase	False
ADPRDP	adprib_c_ + h2o_c_ <=> amp_c_ + 2 h_c_ + r5p_c_	ADPribose diphosphatase	False
ADSK	aps_c_ + atp_c_ <=> adp_c_ + h_c_ + paps_c_	adenylyl-sulfate kinase	False
ADSL1r	dcamp_c_ <=> amp_c_ + fum_c_	adenylsuccinate lyase	True
ADSL2r	_25aics_c_ <=> aicar_c_ + fum_c_	adenylosuccinate lyase	True
ADSS	asp_L_c_ + gtp_c_ + imp_c_ <=> dcamp_c_ + gdp_c_ + 2 h_c_ + pi_c_	adenylosuccinate synthase	False
AGDC	acgam6p_c_ + h2o_c_ <=> ac_c_ + gam6p_c_	N-acetylglucosamine-6-phosphate deacetylase	False
AGM3PApp	anhgm3p_p_ + h2o_p_ <=> LalaDgluMdap_p_ + anhgm_p_	N-Acetyl-D-glucosamine(anhydrous)N-Acetylmuramyl-tripeptide amidase (periplasm)	False
AGM3PH	anhgm3p_c_ + h2o_c_ <=> acgam_c_ + anhm3p_c_	N-Acetyl-D-glucosamine(anhydrous)N-Acetylmuramyl-tripeptide beta -1,4-N-acetylglucosaminidase	False
AGM4PCP	anhgm4p_c_ + h2o_c_ <=> ala_D_c_ + anhgm3p_c_	N-Acetyl-D-glucosamine(anhydrous)N-Acetylmuramyl-tetrapeptide L,D-carboxypeptidase	False
AGM4Pt2pp	anhgm4p_p_ + h_p_ <=> anhgm4p_c_ + h_c_	GlcNAc-anhMurNAc tetrapeptide transport in via proton symport (periplasm)	False
AGMHE	adphep_DD_c_ <=> adphep_LD_c_	ADP-D-glycero-D-manno-heptose epimerase	False
AGPAT120	_1ddecg3p_c_ + ddcaACP_c_ <=> ACP_c_ + pa120_c_	 1-tetradecanoyl-sn-glycerol 3-phosphate O-acyltransferase (n-C12:0)	False
AGPAT160	_1hdecg3p_c_ + palmACP_c_ <=> ACP_c_ + pa160_c_	 1-hexadecanoyl-sn-glycerol 3-phosphate O-acyltransferase (n-C16:0)	False
AGPAT161	_1hdec9eg3p_c_ + hdeACP_c_ <=> ACP_c_ + pa161_c_	 1-hexadec-7-enoyl-sn-glycerol 3-phosphate O-acyltransferase (n-C16:1)	False
AGPR	acg5sa_c_ + nadp_c_ + pi_c_ <=> acg5p_c_ + h_c_ + nadph_c_	N-acetyl-g-glutamyl-phosphate reductase	True
AHCYSNS	ahcys_c_ + h2o_c_ <=> ade_c_ + rhcys_c_	S-adenosylhomocysteine nucleosidase	False
AICART	_10fthf_c_ + aicar_c_ <=> fprica_c_ + thf_c_	phosphoribosylaminoimidazolecarboxamide formyltransferase	True
AIRC2	air_c_ + atp_c_ + hco3_c_ <=> _5caiz_c_ + adp_c_ + h_c_ + pi_c_	phosphoribosylaminoimidazole carboxylase	False
AIRC3	_5aizc_c_ <=> _5caiz_c_	phosphoribosylaminoimidazole carboxylase (mutase rxn)	True
AKGDH	akg_c_ + coa_c_ + nad_c_ <=> co2_c_ + nadh_c_ + succoa_c_	 2-Oxogluterate dehydrogenase	False
ALAALAabcpp	alaala_p_ + atp_c_ + h2o_c_ <=> adp_c_ + alaala_c_ + h_c_ + pi_c_	D-alanyl-D-alanine (DalaDala) transport via ABC system (periplasm)	False
ALAALAr	2 ala_D_c_ + atp_c_ <=> adp_c_ + alaala_c_ + h_c_ + pi_c_	D-alanine-D-alanine ligase (reversible)	True
ALAR	ala_L_c_ <=> ala_D_c_	alanine racemase	True
ALATA_L	akg_c_ + ala_L_c_ <=> glu_L_c_ + pyr_c_	L-alanine transaminase	True
ALATA_L2	ala_L_c_ + pydx5p_c_ <=> pyam5p_c_ + pyr_c_	alanine transaminase	False
ALCD2x	etoh_c_ + nad_c_ <=> acald_c_ + h_c_ + nadh_c_	alcohol dehydrogenase (ethanol)	True
AM3PA	anhm3p_c_ + h2o_c_ <=> LalaDgluMdap_c_ + anhm_c_	anhydrous-N-Acetylmuramyl-tripeptide amidase	False
AMPMS2	air_c_ + h2o_c_ + nad_c_ <=> _4ampm_c_ + 2 for_c_ + 3 h_c_ + nadh_c_	 4-amino-2-methyl-5-phosphomethylpyrimidine synthetase	False
ANHGMtex	anhgm_e_ <=> anhgm_p_	GlcNAc-anhMurNAc transport via diffusion (extracellular to periplasm)	True
ANHMK	anhm_c_ + atp_c_ + h2o_c_ <=> acmum6p_c_ + adp_c_ + h_c_	 1,6-anhydrous-N-Acetylmuramate kinase	False
ANPRT	anth_c_ + prpp_c_ <=> ppi_c_ + pran_c_	anthranilate phosphoribosyltransferase	False
ANS	chor_c_ + gln_L_c_ <=> anth_c_ + glu_L_c_ + h_c_ + pyr_c_	anthranilate synthase	False
APRAUR	_5apru_c_ + h_c_ + nadph_c_ <=> _5aprbu_c_ + nadp_c_	 5-amino-6-(5-phosphoribosylamino)uracil reductase	False
ARGSL	argsuc_c_ <=> arg_L_c_ + fum_c_	argininosuccinate lyase	True
ARGSS	asp_L_c_ + atp_c_ + citr_L_c_ <=> amp_c_ + argsuc_c_ + h_c_ + ppi_c_	argininosuccinate synthase	False
ARGt3pp	arg_L_c_ + h_p_ <=> arg_L_p_ + h_c_	L-arginine transport out via proton antiport (cytoplasm to periplasm)	False
ARGtex	arg_L_e_ <=> arg_L_p_	L-arginine transport via diffusion (extracellular to periplasm)	True
ASAD	aspsa_c_ + nadp_c_ + pi_c_ <=> _4pasp_c_ + h_c_ + nadph_c_	aspartate-semialdehyde dehydrogenase	True
ASNS2	asp_L_c_ + atp_c_ + nh4_c_ <=> amp_c_ + asn_L_c_ + h_c_ + ppi_c_	asparagine synthetase	False
ASP1DC	asp_L_c_ + h_c_ <=> ala_B_c_ + co2_c_	aspartate 1-decarboxylase	False
ASPCT	asp_L_c_ + cbp_c_ <=> cbasp_c_ + h_c_ + pi_c_	aspartate carbamoyltransferase	False
ASPK	asp_L_c_ + atp_c_ <=> _4pasp_c_ + adp_c_	aspartate kinase	True
ASPO5	asp_L_c_ + fum_c_ <=> h_c_ + iasp_c_ + succ_c_	L-aspartate oxidase	False
ASPTA	akg_c_ + asp_L_c_ <=> glu_L_c_ + oaa_c_	aspartate transaminase	True
ATPPRT	atp_c_ + prpp_c_ <=> ppi_c_ + prbatp_c_	ATP phosphoribosyltransferase	False
ATPS4rpp	adp_c_ + 4 h_p_ + pi_c_ <=> atp_c_ + h2o_c_ + 3 h_c_	ATP synthase (four protons for one ATP) (periplasm)	True
BPNT	h2o_c_ + pap_c_ <=> amp_c_ + pi_c_	 3',5'-bisphosphate nucleotidase	False
CA2tex	ca2_e_ <=> ca2_p_	calcium (Ca+2) transport via diffusion (extracellular to periplasm)	True
CAt6pp	ca2_c_ + na1_p_ <=> ca2_p_ + na1_c_	calcium / sodium antiporter (1:1)	True
CBMKr	atp_c_ + co2_c_ + nh4_c_ <=> adp_c_ + cbp_c_ + 2 h_c_	Carbamate kinase	True
CDPMEK	_4c2me_c_ + atp_c_ <=> _2p4c2me_c_ + adp_c_ + h_c_	 4-(cytidine 5'-diphospho)-2-C-methyl-D-erythritol kinase	False
CHORM	chor_c_ <=> pphn_c_	chorismate mutase	False
CHORS	_3psme_c_ <=> chor_c_ + pi_c_	chorismate synthase	False
CHRPL	chor_c_ <=> _4hbz_c_ + pyr_c_	Chorismate pyruvate lyase	False
CLt3_2pp	2 cl_p_ + h_c_ <=> 2 cl_c_ + h_p_	chloride transport out via proton antiport (2:1) (periplasm)	False
CLtex	cl_e_ <=> cl_p_	chloride (Cl-1) transport via diffusion (extracellular to periplasm)	True
CMPN	cmp_c_ + h2o_c_ <=> csn_c_ + r5p_c_	CMP nucleosidase	False
CO2tex	co2_e_ <=> co2_p_	CO2 transport via diffusion (extracellular to periplasm)	True
CO2tpp	co2_p_ <=> co2_c_	CO2 transporter via diffusion (periplasm)	True
COBALT2tex	cobalt2_e_ <=> cobalt2_p_	cobalt (Co+2) transport via diffusion (extracellular to periplasm)	True
COBALT2tpp	cobalt2_p_ <=> cobalt2_c_	cobalt transport in via permease (no H+)	False
COLIPAabcpp	atp_c_ + colipa_c_ + h2o_c_ <=> adp_c_ + colipa_p_ + h_c_ + pi_c_	core oligosaccharide lipid A transport via ABC system (periplasm)	False
CPPPGO	cpppg3_c_ + 2 h_c_ + o2_c_ <=> 2 co2_c_ + 2 h2o_c_ + pppg9_c_	coproporphyrinogen oxidase (O2 required)	False
CPPPGO2	2 amet_c_ + cpppg3_c_ <=> 2 co2_c_ + 2 dad_5_c_ + 2 met_L_c_ + pppg9_c_	Oxygen Independent coproporphyrinogen-III oxidase	False
CRNabcpp	atp_c_ + crn_p_ + h2o_c_ <=> adp_c_ + crn_c_ + h_c_ + pi_c_	L-carnitine transport via ABC system (periplasm)	False
CRNt2rpp	crn_p_ + h_p_ <=> crn_c_ + h_c_	L-carnitine outward transport (H+ antiport)	True
CS	accoa_c_ + h2o_c_ + oaa_c_ <=> cit_c_ + coa_c_ + h_c_	citrate synthase	False
CSND	csn_c_ + h2o_c_ + h_c_ <=> nh4_c_ + ura_c_	Cytosine deaminase	False
CTPS2	atp_c_ + gln_L_c_ + h2o_c_ + utp_c_ <=> adp_c_ + ctp_c_ + glu_L_c_ + 2 h_c_ + pi_c_	CTP synthase (glutamine)	False
CU2tex	cu2_e_ <=> cu2_p_	copper (Cu+2) transport via diffusion (extracellular to periplasm)	True
CU2tpp	cu2_p_ <=> cu2_c_	copper transport in via permease (no H+)	False
CYSS	acser_c_ + h2s_c_ <=> ac_c_ + cys_L_c_ + h_c_	cysteine synthase	False
CYSTL	cyst_L_c_ + h2o_c_ <=> hcys_L_c_ + nh4_c_ + pyr_c_	cystathionine b-lyase	False
CYTBDpp	2 h_c_ + 0.50 o2_c_ + q8h2_c_ <=> h2o_c_ + 2 h_p_ + q8_c_	cytochrome oxidase bd (ubiquinol-8: 2 protons) (periplasm)	False
CYTDK2	cytd_c_ + gtp_c_ <=> cmp_c_ + gdp_c_ + h_c_	cytidine kinase (GTP)	False
CYTK1	atp_c_ + cmp_c_ <=> adp_c_ + cdp_c_	cytidylate kinase (CMP)	True
CYTK2	atp_c_ + dcmp_c_ <=> adp_c_ + dcdp_c_	cytidylate kinase (dCMP)	True
DALAt2pp	ala_D_p_ + h_p_ <=> ala_D_c_ + h_c_	D-alanine transport in via proton symport (periplasm)	False
DAPDC	_26dap_M_c_ + h_c_ <=> co2_c_ + lys_L_c_	diaminopimelate decarboxylase	False
DAPE	_26dap_LL_c_ <=> _26dap_M_c_	diaminopimelate epimerase	True
DASYN160	ctp_c_ + h_c_ + pa160_c_ <=> cdpdhdecg_c_ + ppi_c_	CDP-diacylglycerol synthetase (n-C16:0)	False
DASYN161	ctp_c_ + h_c_ + pa161_c_ <=> cdpdhdec9eg_c_ + ppi_c_	CDP-diacylglycerol synthetase (n-C16:1)	False
DB4PS	ru5p_D_c_ <=> db4p_c_ + for_c_ + h_c_	 3,4-Dihydroxy-2-butanone-4-phosphate synthase	False
DDPA	e4p_c_ + h2o_c_ + pep_c_ <=> _2dda7p_c_ + pi_c_	 3-deoxy-D-arabino-heptulosonate 7-phosphate synthetase	False
DGK1	atp_c_ + dgmp_c_ <=> adp_c_ + dgdp_c_	deoxyguanylate kinase (dGMP:ATP)	True
DHAD1	_23dhmb_c_ <=> _3mob_c_ + h2o_c_	dihydroxy-acid dehydratase (2,3-dihydroxy-3-methylbutanoate)	False
DHAD2	_23dhmp_c_ <=> _3mop_c_ + h2o_c_	Dihydroxy-acid dehydratase (2,3-dihydroxy-3-methylpentanoate)	False
DHBD	_23ddhb_c_ + nad_c_ <=> _23dhb_c_ + h_c_ + nadh_c_	 2,3-dihydro-2,3-dihydroxybenzoate dehydrogenase	True
DHBS	_23dhb_c_ + atp_c_ + h_c_ <=> _23dhba_c_ + ppi_c_	 2,3-dihydroxybenzoate adenylate synthase	False
DHDPRy	_23dhdp_c_ + h_c_ + nadph_c_ <=> nadp_c_ + thdp_c_	dihydrodipicolinate reductase (NADPH)	False
DHDPS	aspsa_c_ + pyr_c_ <=> _23dhdp_c_ + 2 h2o_c_ + h_c_	dihydrodipicolinate synthase	False
DHFR	dhf_c_ + h_c_ + nadph_c_ <=> nadp_c_ + thf_c_	dihydrofolate reductase	True
DHFS	atp_c_ + dhpt_c_ + glu_L_c_ <=> adp_c_ + dhf_c_ + h_c_ + pi_c_	dihydrofolate synthase	False
DHNPA2	dhnpt_c_ <=> _6hmhpt_c_ + gcald_c_	dihydroneopterin aldolase	False
DHORD5	dhor_S_c_ + mqn8_c_ <=> mql8_c_ + orot_c_	dihydroorotic acid (menaquinone-8)	False
DHORTS	dhor_S_c_ + h2o_c_ <=> cbasp_c_ + h_c_	dihydroorotase	True
DHPPDA2	_25drapp_c_ + h2o_c_ + h_c_ <=> _5apru_c_ + nh4_c_	diaminohydroxyphosphoribosylaminopryrimidine deaminase (25drapp)	False
DHPS2	_4abz_c_ + _6hmhptpp_c_ <=> dhpt_c_ + ppi_c_	dihydropteroate synthase	False
DHPTDCs	dhptd_c_ <=> h2o_c_ + hmfurn_c_	 4,5-dihydroxy-2,3-pentanedione cyclization (spontaneous)	False
DHQS	_2dda7p_c_ <=> _3dhq_c_ + pi_c_	 3-dehydroquinate synthase	False
DHQTi	_3dhq_c_ <=> _3dhsk_c_ + h2o_c_	 3-dehydroquinate dehydratase, irreversible	False
DMATT	dmpp_c_ + ipdp_c_ <=> grdp_c_ + ppi_c_	dimethylallyltranstransferase	False
DMPPS	h2mb4p_c_ + h_c_ + nadh_c_ <=> dmpp_c_ + h2o_c_ + nad_c_	 1-hydroxy-2-methyl-2-(E)-butenyl 4-diphosphate reductase (dmpp)	False
DM_4HBA	_4hba_c_ <=> 	Sink needed to allow 4-hydroxy-benzoate to leave system	False
DM_5DRIB	_5drib_c_ <=> 	Sink needed to allow 5'-deoxyribose to leave system	False
DM_HMFURN	hmfurn_c_ <=> 	Sink needed to allow 4-hydroxy-5-methyl-3(2H)-furanone to leave system	False
DNMPPA	dhpmp_c_ + h2o_c_ <=> dhnpt_c_ + pi_c_	Dihydroneopterin monophosphate dephosphorylase	False
DNTPPA	ahdt_c_ + h2o_c_ <=> dhpmp_c_ + h_c_ + ppi_c_	Dihydroneopterin triphosphate pyrophosphatase	False
DPCOAK	atp_c_ + dpcoa_c_ <=> adp_c_ + coa_c_ + h_c_	dephospho-CoA kinase	False
DPR	_2dhp_c_ + h_c_ + nadph_c_ <=> nadp_c_ + pant_R_c_	 2-dehydropantoate 2-reductase	False
DTMPK	atp_c_ + dtmp_c_ <=> adp_c_ + dtdp_c_	dTMP kinase	True
DURIK1	atp_c_ + duri_c_ <=> adp_c_ + dump_c_ + h_c_	deoxyuridine kinase (ATP:Deoxyuridine)	False
DURIPP	duri_c_ + pi_c_ <=> _2dr1p_c_ + ura_c_	deoxyuridine phosphorylase	True
DXPRIi	dxyl5p_c_ + h_c_ + nadph_c_ <=> _2me4p_c_ + nadp_c_	 1-deoxy-D-xylulose reductoisomerase	False
DXPS	g3p_c_ + h_c_ + pyr_c_ <=> co2_c_ + dxyl5p_c_	 1-deoxy-D-xylulose 5-phosphate synthase	False
E4PD	e4p_c_ + h2o_c_ + nad_c_ <=> _4per_c_ + 2 h_c_ + nadh_c_	Erythrose 4-phosphate dehydrogenase	True
EAR100x	h_c_ + nadh_c_ + tdec2eACP_c_ <=> dcaACP_c_ + nad_c_	enoyl-[acyl-carrier-protein] reductase (NADH) (n-C10:0)	False
EAR120x	h_c_ + nadh_c_ + tddec2eACP_c_ <=> ddcaACP_c_ + nad_c_	enoyl-[acyl-carrier-protein] reductase (NADH) (n-C12:0)	False
EAR121x	h_c_ + nadh_c_ + t3c5ddeceACP_c_ <=> cddec5eACP_c_ + nad_c_	enoyl-[acyl-carrier-protein] reductase (NADH) (n-C12:1)	False
EAR140x	h_c_ + nadh_c_ + tmrs2eACP_c_ <=> myrsACP_c_ + nad_c_	enoyl-[acyl-carrier-protein] reductase (NADH) (n-C14:0)	False
EAR141x	h_c_ + nadh_c_ + t3c7mrseACP_c_ <=> nad_c_ + tdeACP_c_	enoyl-[acyl-carrier-protein] reductase (NADH) (n-C14:1)	False
EAR160x	h_c_ + nadh_c_ + tpalm2eACP_c_ <=> nad_c_ + palmACP_c_	enoyl-[acyl-carrier-protein] reductase (NADH) (n-C16:0)	False
EAR161x	h_c_ + nadh_c_ + t3c9palmeACP_c_ <=> hdeACP_c_ + nad_c_	enoyl-[acyl-carrier-protein] reductase (NADH) (n-C16:1)	False
EAR40x	but2eACP_c_ + h_c_ + nadh_c_ <=> butACP_c_ + nad_c_	enoyl-[acyl-carrier-protein] reductase (NADH) (n-C4:0)	False
EAR60x	h_c_ + nadh_c_ + thex2eACP_c_ <=> hexACP_c_ + nad_c_	enoyl-[acyl-carrier-protein] reductase (NADH) (n-C6:0)	False
EAR80x	h_c_ + nadh_c_ + toct2eACP_c_ <=> nad_c_ + ocACP_c_	enoyl-[acyl-carrier-protein] reductase (NADH) (n-C8:0)	False
ECOAH1	_3hbcoa_c_ <=> b2coa_c_ + h2o_c_	 3-hydroxyacyl-CoA dehydratase (3-hydroxybutanoyl-CoA)	True
ECOAH2	_3hhcoa_c_ <=> h2o_c_ + hx2coa_c_	 3-hydroxyacyl-CoA dehydratase (3-hydroxyhexanoyl-CoA)	True
ECOAH3	_3hocoa_c_ <=> h2o_c_ + oc2coa_c_	 3-hydroxyacyl-CoA dehydratase (3-hydroxyoctanoyl-CoA)	True
ECOAH4	_3hdcoa_c_ <=> dc2coa_c_ + h2o_c_	 3-hydroxyacyl-CoA dehydratase (3-hydroxydecanoyl-CoA)	True
ECOAH5	_3hddcoa_c_ <=> dd2coa_c_ + h2o_c_	 3-hydroxyacyl-CoA dehydratase (3-hydroxydodecanoyl-CoA)	True
EDTXS1	ddcaACP_c_ + kdo2lipid4_c_ <=> ACP_c_ + kdo2lipid4L_c_	Endotoxin Synthesis (lauroyl transferase)	False
EDTXS2	kdo2lipid4L_c_ + myrsACP_c_ <=> ACP_c_ + lipa_c_	Endotoxin Synthesis (myristoyl transferase)	False
ENO	_2pg_c_ <=> h2o_c_ + pep_c_	enolase	True
ENTCS	3 _23dhba_c_ + 3 seramp_c_ <=> 6 amp_c_ + enter_c_ + 9 h_c_	enterochelin synthase	False
ETOHt2rpp	etoh_p_ + h_p_ <=> etoh_c_ + h_c_	ethanol reversible transport via proton symport (periplasm)	True
ETOHtex	etoh_e_ <=> etoh_p_	ethanol transport via diffusion (extracellular to periplasm)	True
EX_ac_e_	ac_e_ <=> 	Acetate exchange	True
EX_acald_e_	acald_e_ <=> 	Acetaldehyde exchange	True
EX_acolipa_e_	acolipa_e_ <=> 	 4-Amino-4-deoxy-L-arabinose modified core oligosaccharide lipid A exchange	True
EX_anhgm_e_	anhgm_e_ <=> 	N-Acetyl-D-glucosamine(anhydrous)N-Acetylmuramic acid exchange	True
EX_arg_L_e_	arg_L_e_ <=> 	L-Arginine exchange	True
EX_ca2_e_	ca2_e_ <=> 	Calcium exchange	True
EX_cl_e_	cl_e_ <=> 	Chloride exchange	True
EX_co2_e_	co2_e_ <=> 	CO2 exchange	True
EX_cobalt2_e_	cobalt2_e_ <=> 	Co2+ exchange	True
EX_cu2_e_	cu2_e_ <=> 	Cu2+ exchange	True
EX_enter_e_	enter_e_ <=> 	Enterochelin exchange	True
EX_etoh_e_	etoh_e_ <=> 	Ethanol exchange	True
EX_fe2_e_	fe2_e_ <=> 	Fe2+ exchange	True
EX_fe3_e_	fe3_e_ <=> 	Fe3+ exchange	True
EX_for_e_	for_e_ <=> 	Formate exchange	True
EX_glc_e_	glc_D_e_ <=> 	D-Glucose exchange	True
EX_h2o_e_	h2o_e_ <=> 	H2O exchange	True
EX_h2s_e_	h2s_e_ <=> 	Hydrogen sulfide exchange	True
EX_idon_L_e_	idon_L_e_ <=> 	L-Idonate exchange	True
EX_k_e_	k_e_ <=> 	K+ exchange	True
EX_kdo2lipid4_e_	kdo2lipid4_e_ <=> 	KDO(2)-lipid IV(A) exchange	True
EX_mg2_e_	mg2_e_ <=> 	Mg exchange	True
EX_mn2_e_	mn2_e_ <=> 	Mn2+ exchange	True
EX_mobd_e_	mobd_e_ <=> 	Molybdate exchange	True
EX_nh4_e_	nh4_e_ <=> 	Ammonia exchange	True
EX_o2_e_	o2_e_ <=> 	O2 exchange	True
EX_pi_e_	pi_e_ <=> 	Phosphate exchange	True
EX_pro_L_e_	pro_L_e_ <=> 	L-Proline exchange	True
EX_pyr_e_	pyr_e_ <=> 	Pyruvate exchange	True
EX_so4_e_	so4_e_ <=> 	Sulfate exchange	True
EX_zn2_e_	zn2_e_ <=> 	Zinc exchange	True
Ec_biomass_iAF1260_core_59p81M	0.00 _10fthf_c_ + 0.00 _2ohph_c_ + 0.51 ala_L_c_ + 0.00 amet_c_ + 0.30 arg_L_c_ + 0.24 asn_L_c_ + 0.24 asp_L_c_ + 59.98 atp_c_ + 0.00 ca2_c_ + 0.00 cl_c_ + 0.00 coa_c_ + 0.00 cobalt2_c_ + 0.13 ctp_c_ + 0.00 cu2_c_ + 0.09 cys_L_c_ + 0.03 datp_c_ + 0.03 dctp_c_ + 0.03 dgtp_c_ + 0.03 dttp_c_ + 0.00 fad_c_ + 0.01 fe2_c_ + 0.01 fe3_c_ + 0.26 gln_L_c_ + 0.26 glu_L_c_ + 0.61 gly_c_ + 0.22 gtp_c_ + 54.46 h2o_c_ + 0.09 his_L_c_ + 0.29 ile_L_c_ + 0.18 k_c_ + 0.02 kdo2lipid4_e_ + 0.45 leu_L_c_ + 0.34 lys_L_c_ + 0.15 met_L_c_ + 0.01 mg2_c_ + 0.00 mlthf_c_ + 0.00 mn2_c_ + 0.00 mobd_c_ + 0.01 murein5px4p_p_ + 0.00 nad_c_ + 0.00 nadp_c_ + 0.01 nh4_c_ + 0.02 pe160_c_ + 0.04 pe160_p_ + 0.03 pe161_c_ + 0.05 pe161_p_ + 0.18 phe_L_c_ + 0.00 pheme_c_ + 0.22 pro_L_c_ + 0.00 pydx5p_c_ + 0.00 ribflv_c_ + 0.22 ser_L_c_ + 0.00 sheme_c_ + 0.00 so4_c_ + 0.00 thf_c_ + 0.00 thmpp_c_ + 0.25 thr_L_c_ + 0.06 trp_L_c_ + 0.14 tyr_L_c_ + 0.00 udcpdp_c_ + 0.14 utp_c_ + 0.42 val_L_c_ + 0.00 zn2_c_ <=> 59.81 adp_c_ + 59.81 h_c_ + 59.81 pi_c_ + 0.77 ppi_c_	E. coli biomass objective function (iAF1260) - core - with 59.81 GAM estimate	False
FACOAE60	h2o_c_ + hxcoa_c_ <=> coa_c_ + h_c_ + hxa_c_	fatty-acid-CoA thioesterase (hexanoate)	False
FACOAL120t2pp	atp_c_ + coa_c_ + ddca_p_ + h_p_ <=> amp_c_ + ddcacoa_c_ + h_c_ + ppi_c_	fatty-acid-CoA ligase (dodecanoate transport via vectoral Co-A coupling)	False
FBA	fdp_c_ <=> dhap_c_ + g3p_c_	fructose-bisphosphate aldolase	True
FCLT	fe2_c_ + ppp9_c_ <=> 2 h_c_ + pheme_c_	Ferrochelatase	False
FE2tex	fe2_e_ <=> fe2_p_	iron (II) transport via diffusion (extracellular to periplasm)	True
FE2tpp	fe2_p_ <=> fe2_c_	iron (+2) transport in via permease (no H+)	False
FE3Ri	fadh2_c_ + 2 fe3_c_ <=> fad_c_ + 2 fe2_c_ + 2 h_c_	Fe(III) reduction	False
FE3abcpp	atp_c_ + fe3_p_ + h2o_c_ <=> adp_c_ + fe3_c_ + h_c_ + pi_c_	iron (III) transport via ABC system (periplasm to cytoplasm)	False
FE3tex	fe3_e_ <=> fe3_p_	iron (III) transport via diffusion (extracellular to periplasm)	True
FEENTERtex	enter_p_ + h_p_ <=> enter_e_ + h_c_	enterochelin transport (secretion periplasm)	False
FEENTERtpp	enter_c_ + h_p_ <=> enter_p_ + h_c_	enterochelin transport (secretion)	False
FLDR	fldox_c_ + h_c_ + nadph_c_ <=> fldrd_c_ + nadp_c_	flavodoxin reductase (NADPH)	False
FMNAT	atp_c_ + fmn_c_ + h_c_ <=> fad_c_ + ppi_c_	FMN adenylyltransferase	False
FORtex	for_e_ <=> for_p_	formate transport via diffusion (extracellular to periplasm)	True
FORtppi	for_c_ <=> for_p_	formate transport via diffusion (cytoplasm to periplasm)	False
FRD2	fum_c_ + mql8_c_ <=> mqn8_c_ + succ_c_	fumarate reductase	False
FUM	fum_c_ + h2o_c_ <=> mal_L_c_	fumarase	True
G1PACT	accoa_c_ + gam1p_c_ <=> acgam1p_c_ + coa_c_ + h_c_	glucosamine-1-phosphate N-acetyltransferase	False
G1PTT	dttp_c_ + g1p_c_ + h_c_ <=> dtdpglu_c_ + ppi_c_	glucose-1-phosphate thymidylyltransferase	False
G1SAT	glu1sa_c_ <=> _5aop_c_	glutamate-1-semialdehyde aminotransferase	True
G3PAT120	ddcaACP_c_ + glyc3p_c_ <=> _1ddecg3p_c_ + ACP_c_	glycerol-3-phosphate acyltransferase (C12:0)	False
G3PAT160	glyc3p_c_ + palmACP_c_ <=> _1hdecg3p_c_ + ACP_c_	glycerol-3-phosphate acyltransferase (C16:0)	False
G3PAT161	glyc3p_c_ + hdeACP_c_ <=> _1hdec9eg3p_c_ + ACP_c_	glycerol-3-phosphate acyltransferase (C16:1)	False
G3PD2	glyc3p_c_ + nadp_c_ <=> dhap_c_ + h_c_ + nadph_c_	glycerol-3-phosphate dehydrogenase (NADP)	True
G5SADs	glu5sa_c_ <=> _1pyr5c_c_ + h2o_c_ + h_c_	L-glutamate 5-semialdehyde dehydratase (spontaneous)	False
G5SD	glu5p_c_ + h_c_ + nadph_c_ <=> glu5sa_c_ + nadp_c_ + pi_c_	glutamate-5-semialdehyde dehydrogenase	False
G6PDH2r	g6p_c_ + nadp_c_ <=> _6pgl_c_ + h_c_ + nadph_c_	glucose 6-phosphate dehydrogenase	True
G6PP	g6p_c_ + h2o_c_ <=> glc_D_c_ + pi_c_	glucose-6-phosphate phosphatase	False
GALT1	gicolipa_c_ + udpg_c_ <=> gagicolipa_c_ + h_c_ + udp_c_	galactosyltransferase I (LPS core synthesis)	False
GALUi	g1p_c_ + h_c_ + utp_c_ <=> ppi_c_ + udpg_c_	UTP-glucose-1-phosphate uridylyltransferase (irreversible)	False
GAPD	g3p_c_ + nad_c_ + pi_c_ <=> _13dpg_c_ + h_c_ + nadh_c_	glyceraldehyde-3-phosphate dehydrogenase	True
GARFT	_10fthf_c_ + gar_c_ <=> fgam_c_ + h_c_ + thf_c_	phosphoribosylglycinamide formyltransferase	True
GART	atp_c_ + for_c_ + gar_c_ <=> adp_c_ + fgam_c_ + h_c_ + pi_c_	GAR transformylase-T	False
GCALDD	gcald_c_ + h2o_c_ + nad_c_ <=> glyclt_c_ + 2 h_c_ + nadh_c_	Glycolaldehyde dehydrogenase	False
GF6PTA	f6p_c_ + gln_L_c_ <=> gam6p_c_ + glu_L_c_	glutamine-fructose-6-phosphate transaminase	False
GHMT2r	ser_L_c_ + thf_c_ <=> gly_c_ + h2o_c_ + mlthf_c_	glycine hydroxymethyltransferase, reversible	True
GK1	atp_c_ + gmp_c_ <=> adp_c_ + gdp_c_	guanylate kinase (GMP:ATP)	True
GLCDpp	glc_D_p_ + h2o_p_ + q8_c_ <=> glcn_p_ + h_p_ + q8h2_c_	Glucose dehydrogenase (ubiquinone-8 as acceptor) (periplasm)	False
GLCNt2rpp	glcn_p_ + h_p_ <=> glcn_c_ + h_c_	D-gluconate transport via proton symport, reversible (periplasm)	True
GLCP	glycogen_c_ + pi_c_ <=> g1p_c_	glycogen phosphorylase	False
GLCS1	adpglc_c_ <=> adp_c_ + glycogen_c_ + h_c_	glycogen synthase (ADPGlc)	False
GLCTR1	icolipa_c_ + udpg_c_ <=> gicolipa_c_ + h_c_ + udp_c_	glucosyltransferase I (LPS core synthesis)	False
GLCTR2	gagicolipa_c_ + udpg_c_ <=> ggagicolipa_c_ + h_c_ + udp_c_	glucosyltransferase II (LPS core synthesis)	False
GLCTR3	ggagicolipa_c_ + udpg_c_ <=> gggagicolipa_c_ + h_c_ + udp_c_	glucosyltransferase III (LPS core synthesis)	False
GLCptspp	glc_D_p_ + pep_c_ <=> g6p_c_ + pyr_c_	D-glucose transport via PEP:Pyr PTS (periplasm)	False
GLCtexi	glc_D_e_ <=> glc_D_p_	D-glucose transport via diffusion (extracellular to periplasm) irreversible	False
GLGC	atp_c_ + g1p_c_ + h_c_ <=> adpglc_c_ + ppi_c_	glucose-1-phosphate adenylyltransferase	False
GLNS	atp_c_ + glu_L_c_ + nh4_c_ <=> adp_c_ + gln_L_c_ + h_c_ + pi_c_	glutamine synthetase	False
GLU5K	atp_c_ + glu_L_c_ <=> adp_c_ + glu5p_c_	glutamate 5-kinase	False
GLUDy	glu_L_c_ + h2o_c_ + nadp_c_ <=> akg_c_ + h_c_ + nadph_c_ + nh4_c_	glutamate dehydrogenase (NADP)	True
GLUPRT	gln_L_c_ + h2o_c_ + prpp_c_ <=> glu_L_c_ + ppi_c_ + pram_c_	glutamine phosphoribosyldiphosphate amidotransferase	False
GLUR	glu_D_c_ <=> glu_L_c_	glutamate racemase	True
GLUTRR	glutrna_c_ + h_c_ + nadph_c_ <=> glu1sa_c_ + nadp_c_ + trnaglu_c_	glutamyl-tRNA reductase	False
GLUTRS	atp_c_ + glu_L_c_ + trnaglu_c_ <=> amp_c_ + glutrna_c_ + ppi_c_	Glutamyl-tRNA synthetase	False
GLYAT	accoa_c_ + gly_c_ <=> _2aobut_c_ + coa_c_	glycine C-acetyltransferase	True
GLYC3Pabcpp	atp_c_ + glyc3p_p_ + h2o_c_ <=> adp_c_ + glyc3p_c_ + h_c_ + pi_c_	sn-Glycerol 3-phosphate transport via ABC system (periplasm)	False
GLYCTO2	glyclt_c_ + q8_c_ <=> glx_c_ + q8h2_c_	Glycolate oxidase	False
GMHEPAT	atp_c_ + gmhep1p_c_ + h_c_ <=> adphep_DD_c_ + ppi_c_	D-glycero-D-manno-hepose 1-phosphate adenyltransferase	False
GMHEPK	atp_c_ + gmhep7p_c_ <=> adp_c_ + gmhep17bp_c_ + h_c_	D-glycero-D-manno-heptose 7-phosphate kinase	False
GMHEPPA	gmhep17bp_c_ + h2o_c_ <=> gmhep1p_c_ + pi_c_	D-glycero-D-manno-heptose 1,7-bisphosphate phosphatase	False
GMPS2	atp_c_ + gln_L_c_ + h2o_c_ + xmp_c_ <=> amp_c_ + glu_L_c_ + gmp_c_ + 2 h_c_ + ppi_c_	GMP synthase	False
GND	_6pgc_c_ + nadp_c_ <=> co2_c_ + nadph_c_ + ru5p_D_c_	phosphogluconate dehydrogenase	False
GRTT	grdp_c_ + ipdp_c_ <=> frdp_c_ + ppi_c_	geranyltranstransferase	False
GRXR	grxox_c_ + 2 gthrd_c_ <=> grxrd_c_ + gthox_c_	glutaredoxin reductase	False
GSNK	atp_c_ + gsn_c_ <=> adp_c_ + gmp_c_ + h_c_	guanosine kinase	False
GTHOr	gthox_c_ + h_c_ + nadph_c_ <=> 2 gthrd_c_ + nadp_c_	glutathione oxidoreductase	True
GTPCI	gtp_c_ + h2o_c_ <=> ahdt_c_ + for_c_ + h_c_	GTP cyclohydrolase I	False
GTPCII2	gtp_c_ + 3 h2o_c_ <=> _25drapp_c_ + for_c_ + 2 h_c_ + ppi_c_	GTP cyclohydrolase II (25drapp)	False
H2Otex	h2o_e_ <=> h2o_p_	H2O transport via diffusion (extracellular to periplasm)	True
H2Otpp	h2o_p_ <=> h2o_c_	H2O transport via diffusion (periplasm)	True
H2St1pp	h2s_c_ <=> h2s_p_	h2s transport (periplasm)	False
H2Stex	h2s_e_ <=> h2s_p_	h2s transport via diffusion (extracellular to periplasm)	True
HACD1i	_3hbcoa_c_ + nad_c_ <=> aacoa_c_ + h_c_ + nadh_c_	 3-hydroxyacyl-CoA dehydrogenase (acetoacetyl-CoA)	False
HACD2i	_3hhcoa_c_ + nad_c_ <=> _3ohcoa_c_ + h_c_ + nadh_c_	 3-hydroxyacyl-CoA dehydrogenase (3-oxohexanoyl-CoA)	False
HACD3i	_3hocoa_c_ + nad_c_ <=> _3oocoa_c_ + h_c_ + nadh_c_	 3-hydroxyacyl-CoA dehydrogenase (3-oxooctanoyl-CoA)	False
HACD4i	_3hdcoa_c_ + nad_c_ <=> _3odcoa_c_ + h_c_ + nadh_c_	 3-hydroxyacyl-CoA dehydrogenase (3-oxodecanoyl-CoA)	False
HACD5i	_3hddcoa_c_ + nad_c_ <=> _3oddcoa_c_ + h_c_ + nadh_c_	 3-hydroxyacyl-CoA dehydrogenase (3-oxododecanoyl-CoA)	False
HBZOPT	_4hbz_c_ + octdp_c_ <=> _3ophb_c_ + ppi_c_	Hydroxybenzoate octaprenyltransferase	False
HCO3E	co2_c_ + h2o_c_ <=> h_c_ + hco3_c_	HCO3 equilibration reaction	True
HEPK1	atp_c_ + hhlipa_c_ <=> adp_c_ + h_c_ + phhlipa_c_	LPS heptose kinase I (LPS core synthesis)	False
HEPK2	atp_c_ + hphhlipa_c_ <=> adp_c_ + h_c_ + phphhlipa_c_	LPS heptose kinase II (LPS core synthesis)	False
HEPT1	adphep_LD_c_ + lipa_c_ <=> adp_c_ + h_c_ + hlipa_c_	heptosyltransferase I (LPS core synthesis)	False
HEPT2	adphep_LD_c_ + hlipa_c_ <=> adp_c_ + h_c_ + hhlipa_c_	heptosyltransferase II (LPS core synthesis)	False
HEPT3	adphep_LD_c_ + phhlipa_c_ <=> adp_c_ + h_c_ + hphhlipa_c_	heptosyltransferase III (LPS core synthesis)	False
HEPT4	adphep_LD_c_ + gggagicolipa_c_ <=> adp_c_ + colipa_c_ + h_c_	heptosyltransferase IV (LPS core synthesis)	False
HEX7	atp_c_ + fru_c_ <=> adp_c_ + f6p_c_ + h_c_	hexokinase (D-fructose:ATP)	False
HISTD	h2o_c_ + histd_c_ + 2 nad_c_ <=> 3 h_c_ + his_L_c_ + 2 nadh_c_	histidinol dehydrogenase	False
HISTP	h2o_c_ + hisp_c_ <=> histd_c_ + pi_c_	histidinol-phosphatase	False
HMBS	h2o_c_ + 4 ppbng_c_ <=> hmbil_c_ + 4 nh4_c_	hydroxymethylbilane synthase	False
HPPK2	_6hmhpt_c_ + atp_c_ <=> _6hmhptpp_c_ + amp_c_ + h_c_	 6-hydroxymethyl-dihydropterin pyrophosphokinase	False
HPYRI	hpyr_c_ <=> _2h3oppan_c_	hydroxypyruvate isomerase	True
HPYRRy	h_c_ + hpyr_c_ + nadph_c_ <=> glyc_R_c_ + nadp_c_	Hydroxypyruvate reductase (NADPH)	False
HSDy	hom_L_c_ + nadp_c_ <=> aspsa_c_ + h_c_ + nadph_c_	homoserine dehydrogenase (NADPH)	True
HSK	atp_c_ + hom_L_c_ <=> adp_c_ + h_c_ + phom_c_	homoserine kinase	False
HSST	hom_L_c_ + succoa_c_ <=> coa_c_ + suchms_c_	homoserine O-succinyltransferase	False
HSTPT	glu_L_c_ + imacp_c_ <=> akg_c_ + hisp_c_	histidinol-phosphate transaminase	False
HXCT	accoa_c_ + hxa_c_ <=> ac_c_ + hxcoa_c_	Acetyl-CoA:hexanoate-CoA transferase	False
ICDHyr	icit_c_ + nadp_c_ <=> akg_c_ + co2_c_ + nadph_c_	isocitrate dehydrogenase (NADP)	True
ICHORSi	chor_c_ <=> ichor_c_	Isochorismate Synthase	False
ICHORT	h2o_c_ + ichor_c_ <=> _23ddhb_c_ + pyr_c_	isochorismatase	False
IDOND	_5dglcn_c_ + h_c_ + nadh_c_ <=> idon_L_c_ + nad_c_	L-idonate 5-dehydrogenase	True
IDONt2rpp	h_p_ + idon_L_p_ <=> h_c_ + idon_L_c_	L-idonate transport via proton symport, reversible (periplasm)	True
IDONtex	idon_L_e_ <=> idon_L_p_	L-idonate transport via diffusion (extracellular to periplasm)	True
IG3PS	gln_L_c_ + prlp_c_ <=> aicar_c_ + eig3p_c_ + glu_L_c_ + h_c_	Imidazole-glycerol-3-phosphate synthase	False
IGPDH	eig3p_c_ <=> h2o_c_ + imacp_c_	imidazoleglycerol-phosphate dehydratase	False
IGPS	_2cpr5p_c_ + h_c_ <=> _3ig3p_c_ + co2_c_ + h2o_c_	indole-3-glycerol-phosphate synthase	False
ILETA	akg_c_ + ile_L_c_ <=> _3mop_c_ + glu_L_c_	isoleucine transaminase	True
IMPC	h2o_c_ + imp_c_ <=> fprica_c_	IMP cyclohydrolase	True
IMPD	h2o_c_ + imp_c_ + nad_c_ <=> h_c_ + nadh_c_ + xmp_c_	IMP dehydrogenase	False
IPDPS	h2mb4p_c_ + h_c_ + nadh_c_ <=> h2o_c_ + ipdp_c_ + nad_c_	 1-hydroxy-2-methyl-2-(E)-butenyl 4-diphosphate reductase (ipdp)	False
IPMD	_3c2hmp_c_ + nad_c_ <=> _3c4mop_c_ + h_c_ + nadh_c_	 3-isopropylmalate dehydrogenase	False
IPPMIa	_3c2hmp_c_ <=> _2ippm_c_ + h2o_c_	 3-isopropylmalate dehydratase	True
IPPMIb	_2ippm_c_ + h2o_c_ <=> _3c3hmp_c_	 2-isopropylmalate hydratase	True
IPPS	_3mob_c_ + accoa_c_ + h2o_c_ <=> _3c3hmp_c_ + coa_c_ + h_c_	 2-isopropylmalate synthase	False
K2L4Aabcpp	atp_c_ + h2o_c_ + kdo2lipid4_c_ <=> adp_c_ + h_c_ + kdo2lipid4_p_ + pi_c_	KDO(2)-lipid IV A transport via ABC system (periplasm)	False
K2L4Atex	kdo2lipid4_p_ <=> kdo2lipid4_e_	KDO(2)-lipid IV A transport via vector (periplasm to extracellular)	False
KARA1	_23dhmb_c_ + nadp_c_ <=> alac_S_c_ + h_c_ + nadph_c_	ketol-acid reductoisomerase (2,3-dihydroxy-3-methylbutanoate)	True
KARA2	_2ahbut_c_ + h_c_ + nadph_c_ <=> _23dhmp_c_ + nadp_c_	ketol-acid reductoisomerase (2-Acetolactate)	True
KAS15	accoa_c_ + h_c_ + malACP_c_ <=> actACP_c_ + co2_c_ + coa_c_	beta-ketoacyl-ACP synthase (2)	False
KAT2	_3ohcoa_c_ + coa_c_ <=> accoa_c_ + btcoa_c_	 3-ketoacyl-CoA thiolase	False
KAT3	_3oocoa_c_ + coa_c_ <=> accoa_c_ + hxcoa_c_	 3-ketoacyl-CoA thiolase	False
KAT4	_3odcoa_c_ + coa_c_ <=> accoa_c_ + occoa_c_	 3-ketoacyl-CoA thiolase	False
KAT5	_3oddcoa_c_ + coa_c_ <=> accoa_c_ + dcacoa_c_	 3-ketoacyl-CoA thiolase	False
KDOCT2	ctp_c_ + kdo_c_ <=> ckdo_c_ + ppi_c_	 3-deoxy-manno-octulosonate cytidylyltransferase	False
KDOPP	h2o_c_ + kdo8p_c_ <=> kdo_c_ + pi_c_	 3-deoxy-manno-octulosonate-8-phosphatase	False
KDOPS	ara5p_c_ + h2o_c_ + pep_c_ <=> kdo8p_c_ + pi_c_	 3-deoxy -D-manno-octulosonic -acid 8-phosphate synthase	False
Kt2pp	h_p_ + k_p_ <=> h_c_ + k_c_	potassium transport in via proton symport (periplasm)	False
Ktex	k_e_ <=> k_p_	potassium transport via diffusion (extracellular to periplasm)	True
LA4NTpp	colipa_p_ + uLa4n_p_ <=> acolipa_p_ + udcpp_p_	 4-amino-4-deoxy-L-arabinotransferase (LPS lipid A modification, periplasmic face of membrane))	False
LDH_D	lac_D_c_ + nad_c_ <=> h_c_ + nadh_c_ + pyr_c_	D-lactate dehydrogenase	True
LDH_D2	lac_D_c_ + q8_c_ <=> pyr_c_ + q8h2_c_	D-lactate dehydrogenase	False
LEUTAi	_4mop_c_ + glu_L_c_ <=> akg_c_ + leu_L_c_	leucine transaminase (irreversible)	False
LPADSS	lipidX_c_ + u23ga_c_ <=> h_c_ + lipidAds_c_ + udp_c_	Lipid A disaccaride synthase	False
LPLIPAL1A120pp	_1ddecg3p_p_ + h2o_p_ <=> ddca_p_ + glyc3p_p_ + h_p_	Lysophospholipase L1 (2-acylglycerophosphotidate, n-C12:0) (periplasm)	False
MALS	accoa_c_ + glx_c_ + h2o_c_ <=> coa_c_ + h_c_ + mal_L_c_	malate synthase	False
MCITD	_2mcit_c_ <=> _2mcacn_c_ + h2o_c_	 2-methylcitrate dehydratase	False
MCITL2	micit_c_ <=> pyr_c_ + succ_c_	methylisocitrate lyase	True
MCITS	h2o_c_ + oaa_c_ + ppcoa_c_ <=> _2mcit_c_ + coa_c_ + h_c_	 2-methylcitrate synthase	False
MCOATA	ACP_c_ + malcoa_c_ <=> coa_c_ + malACP_c_	Malonyl-CoA-ACP transacylase	True
MCTP1App	murein5p5p_p_ <=> ala_D_p_ + murein5px4p_p_	murein crosslinking transpeptidase 1A:(A2pm->D-ala) (periplasm)	False
MDDCP3pp	h2o_p_ + murein5p5p_p_ <=> ala_D_p_ + murein5p4p_p_	murein D,D-carboxypeptidase (murein5p5p) (periplasm)	False
MDDCP4pp	h2o_p_ + murein5p4p_p_ <=> ala_D_p_ + murein4p4p_p_	murein D,D-carboxypeptidase (murein5p4p) (periplasm)	False
MDDCP5pp	h2o_p_ + murein5p3p_p_ <=> ala_D_p_ + murein4p3p_p_	murein D,D-carboxypeptidase (murein5p3p) (periplasm)	False
MDH	mal_L_c_ + nad_c_ <=> h_c_ + nadh_c_ + oaa_c_	malate dehydrogenase	True
MDH2	mal_L_c_ + q8_c_ <=> oaa_c_ + q8h2_c_	Malate dehydrogenase (ubiquinone 8 as acceptor)	False
MECDPDH2	_2mecdp_c_ + nadh_c_ <=> h2mb4p_c_ + h2o_c_ + nad_c_	 2C-methyl-D-erythritol 2,4 cyclodiphosphate dehydratase	False
MECDPS	_2p4c2me_c_ <=> _2mecdp_c_ + cmp_c_	 2-C-methyl-D-erythritol 2,4-cyclodiphosphate synthase	False
MEPCT	_2me4p_c_ + ctp_c_ + h_c_ <=> _4c2me_c_ + ppi_c_	 2-C-methyl-D-erythritol 4-phosphate cytidylyltransferase	False
METAT	atp_c_ + h2o_c_ + met_L_c_ <=> amet_c_ + pi_c_ + ppi_c_	methionine adenosyltransferase	False
METS	_5mthf_c_ + hcys_L_c_ <=> h_c_ + met_L_c_ + thf_c_	methionine synthase	False
MG2tex	mg2_e_ <=> mg2_p_	magnesium (Mg+2) transport via diffusion (extracellular to periplasm)	True
MG2tpp	mg2_p_ <=> mg2_c_	magnesium (+2) transport in via diffusion	False
MICITD	_2mcacn_c_ + h2o_c_ <=> micit_c_	 2-methylisocitrate dehydratase	False
MLDCP2App	h2o_p_ + murein5p5p_p_ <=> alaala_p_ + murein5p3p_p_	murein L,D-carboxypeptidase (murein5p5p) (periplasm)	False
MLTGY1pp	murein4p4p_p_ <=> 2 anhgm4p_p_	murein lytic transglycosylase (murein4p4p) (periplasm)	False
MLTGY2pp	murein4p3p_p_ <=> anhgm3p_p_ + anhgm4p_p_	murein lytic transglycosylase (murein4p3p) (periplasm)	False
MNt2pp	h_p_ + mn2_p_ <=> h_c_ + mn2_c_	manganese (Mn+2) transport in via proton symport (periplasm)	False
MNtex	mn2_e_ <=> mn2_p_	Manganese (Mn+2) transport via diffusion (extracellular to periplasm)	True
MOAT	ckdo_c_ + lipidA_c_ <=> cmp_c_ + h_c_ + kdolipid4_c_	 3-deoxy-D-manno-octulosonic acid transferase	False
MOAT2	ckdo_c_ + kdolipid4_c_ <=> cmp_c_ + h_c_ + kdo2lipid4_c_	 3-deoxy-D-manno-octulosonic acid transferase	False
MOAT3C	ckdo_c_ + phphhlipa_c_ <=> cmp_c_ + h_c_ + kphphhlipa_c_	 3-deoxy-D-manno-octulosonic acid transferase III (LPS core biosynthesis)	False
MOBDabcpp	atp_c_ + h2o_c_ + mobd_p_ <=> adp_c_ + h_c_ + mobd_c_ + pi_c_	molybdate transport via ABC system (periplasm)	False
MOBDtex	mobd_e_ <=> mobd_p_	molybdate transport via diffusion (extracellular to periplasm)	True
MOHMT	_3mob_c_ + h2o_c_ + mlthf_c_ <=> _2dhp_c_ + thf_c_	 3-methyl-2-oxobutanoate hydroxymethyltransferase	False
MPTG	2 uaagmda_c_ <=> 2 h_c_ + murein5p5p_p_ + 2 udcpdp_c_	murein polymerizing transglycosylase	False
MTHFC	h2o_c_ + methf_c_ <=> _10fthf_c_ + h_c_	methenyltetrahydrofolate cyclohydrolase	True
MTHFD	mlthf_c_ + nadp_c_ <=> methf_c_ + nadph_c_	methylenetetrahydrofolate dehydrogenase (NADP)	True
MTHFR2	2 h_c_ + mlthf_c_ + nadh_c_ <=> _5mthf_c_ + nad_c_	 5,10-methylenetetrahydrofolate reductase (NADH)	False
NADH10	h_c_ + mqn8_c_ + nadh_c_ <=> mql8_c_ + nad_c_	NADH dehydrogenase (menaquinone-8 & 0 protons)	False
NADH16pp	4 h_c_ + nadh_c_ + q8_c_ <=> 3 h_p_ + nad_c_ + q8h2_c_	NADH dehydrogenase (ubiquinone-8 & 3 protons) (periplasm)	False
NADK	atp_c_ + nad_c_ <=> adp_c_ + h_c_ + nadp_c_	NAD kinase	False
NADN	h2o_c_ + nad_c_ <=> adprib_c_ + h_c_ + ncam_c_	NAD nucleosidase	False
NADS1	atp_c_ + dnad_c_ + nh4_c_ <=> amp_c_ + h_c_ + nad_c_ + ppi_c_	NAD synthase (nh3)	False
NAMNPP	atp_c_ + h2o_c_ + nac_c_ + prpp_c_ <=> adp_c_ + nicrnt_c_ + pi_c_ + ppi_c_	nicotinic acid mononucleotide pyrophosphorylase	False
NDPK1	atp_c_ + gdp_c_ <=> adp_c_ + gtp_c_	nucleoside-diphosphate kinase (ATP:GDP)	True
NDPK2	atp_c_ + udp_c_ <=> adp_c_ + utp_c_	nucleoside-diphosphate kinase (ATP:UDP)	True
NDPK3	atp_c_ + cdp_c_ <=> adp_c_ + ctp_c_	nucleoside-diphosphate kinase (ATP:CDP)	True
NDPK4	atp_c_ + dtdp_c_ <=> adp_c_ + dttp_c_	nucleoside-diphosphate kinase (ATP:dTDP)	True
NDPK5	atp_c_ + dgdp_c_ <=> adp_c_ + dgtp_c_	nucleoside-diphosphate kinase (ATP:dGDP)	True
NDPK7	atp_c_ + dcdp_c_ <=> adp_c_ + dctp_c_	nucleoside-diphosphate kinase (ATP:dCDP)	True
NDPK8	atp_c_ + dadp_c_ <=> adp_c_ + datp_c_	nucleoside-diphosphate kinase (ATP:dADP)	True
NH4tex	nh4_e_ <=> nh4_p_	ammonia transport via diffusion (extracellular to periplasm)	True
NH4tpp	nh4_p_ <=> nh4_c_	ammonia reversible transport (periplasm)	True
NNAM	h2o_c_ + ncam_c_ <=> nac_c_ + nh4_c_	nicotinamidase	False
NNATr	atp_c_ + h_c_ + nicrnt_c_ <=> dnad_c_ + ppi_c_	nicotinate-nucleotide adenylyltransferase	True
NNDPR	2 h_c_ + prpp_c_ + quln_c_ <=> co2_c_ + nicrnt_c_ + ppi_c_	nicotinate-nucleotide diphosphorylase (carboxylating)	False
NTD2	h2o_c_ + ump_c_ <=> pi_c_ + uri_c_	 5'-nucleotidase (UMP)	False
NTD4	cmp_c_ + h2o_c_ <=> cytd_c_ + pi_c_	 5'-nucleotidase (CMP)	False
NTD6	damp_c_ + h2o_c_ <=> dad_2_c_ + pi_c_	 5'-nucleotidase (dAMP)	False
NTD8	dgmp_c_ + h2o_c_ <=> dgsn_c_ + pi_c_	 5'-nucleotidase (dGMP)	False
NTP10	h2o_c_ + itp_c_ <=> h_c_ + idp_c_ + pi_c_	nucleoside-triphosphatase (ITP)	False
NTPP3	dctp_c_ + h2o_c_ <=> dcmp_c_ + h_c_ + ppi_c_	Nucleoside triphosphate pyrophosphorylase (dctp)	False
NTPP5	datp_c_ + h2o_c_ <=> damp_c_ + h_c_ + ppi_c_	Nucleoside triphosphate pyrophosphorylase (datp)	False
O2tex	o2_e_ <=> o2_p_	oxygen transport via diffusion (extracellular to periplasm)	True
O2tpp	o2_p_ <=> o2_c_	o2 transport via diffusion (periplasm)	True
OBTFL	_2obut_c_ + coa_c_ <=> for_c_ + ppcoa_c_	 2-Oxobutanoate formate lyase	False
OCBT	cbp_c_ + orn_c_ <=> citr_L_c_ + h_c_ + pi_c_	ornithine carbamoyltransferase	True
OCTDPS	frdp_c_ + 5 ipdp_c_ <=> octdp_c_ + 5 ppi_c_	Octaprenyl pyrophosphate synthase	False
OHPBAT	glu_L_c_ + ohpb_c_ <=> akg_c_ + phthr_c_	O-Phospho-4-hydroxy-L-threonine:2-oxoglutarate aminotransferase	True
OMCDC	_3c4mop_c_ + h_c_ <=> _4mop_c_ + co2_c_	 2-Oxo-4-methyl-3-carboxypentanoate decarboxylation	False
OMPDC	h_c_ + orot5p_c_ <=> co2_c_ + ump_c_	orotidine-5'-phosphate decarboxylase	False
OPHBDC	_3ophb_c_ + h_c_ <=> _2oph_c_ + co2_c_	Octaprenyl-hydroxybenzoate decarboxylase	False
OPHHX	_2oph_c_ + 0.50 o2_c_ <=> _2ohph_c_	 2-Octaprenylphenol hydroxylase	False
ORPT	orot5p_c_ + ppi_c_ <=> orot_c_ + prpp_c_	orotate phosphoribosyltransferase	True
P5CR	_1pyr5c_c_ + 2 h_c_ + nadph_c_ <=> nadp_c_ + pro_L_c_	pyrroline-5-carboxylate reductase	False
PA120abcpp	atp_c_ + h2o_c_ + pa120_c_ <=> adp_c_ + h_c_ + pa120_p_ + pi_c_	phosphatidate transport via ABC system (n-C12:0, periplasm)	False
PANTS	ala_B_c_ + atp_c_ + pant_R_c_ <=> amp_c_ + h_c_ + pnto_R_c_ + ppi_c_	pantothenate synthase	False
PAPPT3	udcpp_c_ + ugmda_c_ <=> uagmda_c_ + ump_c_	phospho-N-acetylmuramoyl-pentapeptide-transferase (meso-2,6-diaminopimelate)	False
PAPSR	paps_c_ + trdrd_c_ <=> 2 h_c_ + pap_c_ + so3_c_ + trdox_c_	phosphoadenylyl-sulfate reductase (thioredoxin)	False
PAPSR2	grxrd_c_ + paps_c_ <=> grxox_c_ + 2 h_c_ + pap_c_ + so3_c_	phosphoadenylyl-sulfate reductase (glutaredoxin)	False
PDE1	camp_c_ + h2o_c_ <=> amp_c_ + h_c_	 3',5'-cyclic-nucleotide phosphodiesterase	False
PDH	coa_c_ + nad_c_ + pyr_c_ <=> accoa_c_ + co2_c_ + nadh_c_	pyruvate dehydrogenase	False
PDX5POi	o2_c_ + pdx5p_c_ <=> h2o2_c_ + pydx5p_c_	pyridoxine 5'-phosphate oxidase	False
PDX5PS	dxyl5p_c_ + nad_c_ + phthr_c_ <=> co2_c_ + 2 h2o_c_ + h_c_ + nadh_c_ + pdx5p_c_ + pi_c_	Pyridoxine 5'-phosphate synthase	False
PE160abcpp	atp_c_ + h2o_c_ + pe160_c_ <=> adp_c_ + h_c_ + pe160_p_ + pi_c_	phosphatidylethanolamine transport via ABC system (n-C16:0, periplasm)	False
PE161abcpp	atp_c_ + h2o_c_ + pe161_c_ <=> adp_c_ + h_c_ + pe161_p_ + pi_c_	phosphatidylethanolamine transport via ABC system (n-C16:1, periplasm)	False
PERD	_4per_c_ + nad_c_ <=> h_c_ + nadh_c_ + ohpb_c_	Erythronate 4-phosphate (4per) dehydrogenase	True
PFK	atp_c_ + f6p_c_ <=> adp_c_ + fdp_c_ + h_c_	phosphofructokinase	False
PFL	coa_c_ + pyr_c_ <=> accoa_c_ + for_c_	pyruvate formate lyase	False
PGAMT	gam1p_c_ <=> gam6p_c_	phosphoglucosamine mutase	True
PGCD	_3pg_c_ + nad_c_ <=> _3php_c_ + h_c_ + nadh_c_	phosphoglycerate dehydrogenase	False
PGI	g6p_c_ <=> f6p_c_	glucose-6-phosphate isomerase	True
PGK	_3pg_c_ + atp_c_ <=> _13dpg_c_ + adp_c_	phosphoglycerate kinase	True
PGL	_6pgl_c_ + h2o_c_ <=> _6pgc_c_ + h_c_	 6-phosphogluconolactonase	False
PGM	_2pg_c_ <=> _3pg_c_	phosphoglycerate mutase	True
PGMT	g1p_c_ <=> g6p_c_	phosphoglucomutase	True
PHETA1	akg_c_ + phe_L_c_ <=> glu_L_c_ + phpyr_c_	phenylalanine transaminase	True
PItex	pi_e_ <=> pi_p_	phosphate transport via diffusion (extracellular to periplasm)	True
PIuabcpp	atp_c_ + h2o_c_ + pi_p_ <=> adp_c_ + h_c_ + 2 pi_c_	phosphate transport via ABC system (uptake, periplasm)	False
PLIPA2A120pp	h2o_p_ + pa120_p_ <=> _1ddecg3p_p_ + ddca_p_ + h_p_	Phospholipase A2 (phosphatidate, n-C12:0) (periplasm)	False
PMDPHT	_5aprbu_c_ + h2o_c_ <=> _4r5au_c_ + pi_c_	pyrimidine phosphatase	False
PMPK	_4ampm_c_ + atp_c_ <=> _2mahmp_c_ + adp_c_	phosphomethylpyrimidine kinase	False
PNTK	atp_c_ + pnto_R_c_ <=> _4ppan_c_ + adp_c_ + h_c_	pantothenate kinase	False
PPA	h2o_c_ + ppi_c_ <=> h_c_ + 2 pi_c_	inorganic diphosphatase	False
PPBNGS	2 _5aop_c_ <=> 2 h2o_c_ + h_c_ + ppbng_c_	porphobilinogen synthase	False
PPC	co2_c_ + h2o_c_ + pep_c_ <=> h_c_ + oaa_c_ + pi_c_	phosphoenolpyruvate carboxylase	False
PPCDC	_4ppcys_c_ + h_c_ <=> co2_c_ + pan4p_c_	phosphopantothenoylcysteine decarboxylase	False
PPM	r1p_c_ <=> r5p_c_	phosphopentomutase	True
PPNCL2	_4ppan_c_ + ctp_c_ + cys_L_c_ <=> _4ppcys_c_ + cmp_c_ + h_c_ + ppi_c_	phosphopantothenate-cysteine ligase	False
PPND	nad_c_ + pphn_c_ <=> _34hpp_c_ + co2_c_ + nadh_c_	prephenate dehydrogenase	False
PPNDH	h_c_ + pphn_c_ <=> co2_c_ + h2o_c_ + phpyr_c_	prephenate dehydratase	False
PPPGO3	3 fum_c_ + pppg9_c_ <=> ppp9_c_ + 3 succ_c_	protoporphyrinogen oxidase (anaerobic)	False
PRAGSr	atp_c_ + gly_c_ + pram_c_ <=> adp_c_ + gar_c_ + h_c_ + pi_c_	phosphoribosylglycinamide synthase	True
PRAIS	atp_c_ + fpram_c_ <=> adp_c_ + air_c_ + 2 h_c_ + pi_c_	phosphoribosylaminoimidazole synthase	False
PRAIi	pran_c_ <=> _2cpr5p_c_	phosphoribosylanthranilate isomerase (irreversible)	False
PRAMPC	h2o_c_ + prbamp_c_ <=> prfp_c_	phosphoribosyl-AMP cyclohydrolase	False
PRASCSi	_5aizc_c_ + asp_L_c_ + atp_c_ <=> _25aics_c_ + adp_c_ + h_c_ + pi_c_	phosphoribosylaminoimidazolesuccinocarboxamide synthase	False
PRATPP	h2o_c_ + prbatp_c_ <=> h_c_ + ppi_c_ + prbamp_c_	phosphoribosyl-ATP pyrophosphatase	False
PRFGS	atp_c_ + fgam_c_ + gln_L_c_ + h2o_c_ <=> adp_c_ + fpram_c_ + glu_L_c_ + h_c_ + pi_c_	phosphoribosylformylglycinamidine synthase	False
PRMICI	prfp_c_ <=> prlp_c_	 1-(5-phosphoribosyl)-5-[(5-phosphoribosylamino)methylideneamino)imidazole-4-carboxamide isomerase	True
PROt2rpp	h_p_ + pro_L_p_ <=> h_c_ + pro_L_c_	L-proline reversible transport via proton symport (periplasm)	True
PROtex	pro_L_e_ <=> pro_L_p_	L-proline transport via diffusion (extracellular to periplasm)	True
PRPPS	atp_c_ + r5p_c_ <=> amp_c_ + h_c_ + prpp_c_	phosphoribosylpyrophosphate synthetase	True
PSCVT	pep_c_ + skm5p_c_ <=> _3psme_c_ + pi_c_	 3-phosphoshikimate 1-carboxyvinyltransferase	True
PSD160	h_c_ + ps160_c_ <=> co2_c_ + pe160_c_	Phosphatidylserine decarboxylase (n-C16:0)	False
PSD161	h_c_ + ps161_c_ <=> co2_c_ + pe161_c_	Phosphatidylserine decarboxylase (n-C16:1)	False
PSERT	_3php_c_ + glu_L_c_ <=> akg_c_ + pser_L_c_	phosphoserine transaminase	False
PSP_L	h2o_c_ + pser_L_c_ <=> pi_c_ + ser_L_c_	phosphoserine phosphatase (L-serine)	False
PSSA160	cdpdhdecg_c_ + ser_L_c_ <=> cmp_c_ + h_c_ + ps160_c_	Phosphatidylserine syntase (n-C16:0)	False
PSSA161	cdpdhdec9eg_c_ + ser_L_c_ <=> cmp_c_ + h_c_ + ps161_c_	Phosphatidylserine syntase (n-C16:1)	False
PTAr	accoa_c_ + pi_c_ <=> actp_c_ + coa_c_	phosphotransacetylase	True
PTPATi	atp_c_ + h_c_ + pan4p_c_ <=> dpcoa_c_ + ppi_c_	pantetheine-phosphate adenylyltransferase	False
PUNP1	adn_c_ + pi_c_ <=> ade_c_ + r1p_c_	purine-nucleoside phosphorylase (Adenosine)	True
PUNP2	dad_2_c_ + pi_c_ <=> _2dr1p_c_ + ade_c_	purine-nucleoside phosphorylase (Deoxyadenosine)	True
PUNP3	gsn_c_ + pi_c_ <=> gua_c_ + r1p_c_	purine-nucleoside phosphorylase (Guanosine)	True
PUNP4	dgsn_c_ + pi_c_ <=> _2dr1p_c_ + gua_c_	purine-nucleoside phosphorylase (Deoxyguanosine)	True
PYAM5PO	h2o_c_ + o2_c_ + pyam5p_c_ <=> h2o2_c_ + nh4_c_ + pydx5p_c_	pyridoxamine 5'-phosphate oxidase	False
PYK	adp_c_ + h_c_ + pep_c_ <=> atp_c_ + pyr_c_	pyruvate kinase	False
PYNP2r	pi_c_ + uri_c_ <=> r1p_c_ + ura_c_	pyrimidine-nucleoside phosphorylase (uracil)	True
PYRt2rpp	h_p_ + pyr_p_ <=> h_c_ + pyr_c_	pyruvate reversible transport via proton symport (periplasm)	True
PYRtex	pyr_e_ <=> pyr_p_	pyruvate transport via diffusion (extracellular to periplasm)	True
QULNS	dhap_c_ + iasp_c_ <=> 2 h2o_c_ + pi_c_ + quln_c_	quinolinate synthase	False
RBFK	atp_c_ + ribflv_c_ <=> adp_c_ + fmn_c_ + h_c_	riboflavin kinase	False
RBFSa	_4r5au_c_ + db4p_c_ <=> dmlz_c_ + 2 h2o_c_ + pi_c_	riboflavin synthase	False
RBFSb	2 dmlz_c_ <=> _4r5au_c_ + ribflv_c_	riboflavin synthase	False
RHAT1	dtdprmn_c_ + kphphhlipa_c_ <=> dtdp_c_ + h_c_ + icolipa_c_	rhamnosyltransferase I (LPS core biosynthesis)	False
RHCCE	rhcys_c_ <=> dhptd_c_ + hcys_L_c_	S-ribosylhomocysteine cleavage enzyme	False
RNDR1	adp_c_ + trdrd_c_ <=> dadp_c_ + h2o_c_ + trdox_c_	ribonucleoside-diphosphate reductase (ADP)	False
RNDR2	gdp_c_ + trdrd_c_ <=> dgdp_c_ + h2o_c_ + trdox_c_	ribonucleoside-diphosphate reductase (GDP)	False
RNDR3	cdp_c_ + trdrd_c_ <=> dcdp_c_ + h2o_c_ + trdox_c_	ribonucleoside-diphosphate reductase (CDP)	False
RNDR4b	grxrd_c_ + udp_c_ <=> dudp_c_ + grxox_c_ + h2o_c_	ribonucleoside-diphosphate reductase (UDP) (glutaredoxin)	False
RNTR1c	atp_c_ + fldrd_c_ <=> datp_c_ + fldox_c_ + h2o_c_	ribonucleoside-triphosphate reductase (ATP) (flavodoxin)	False
RPE	ru5p_D_c_ <=> xu5p_D_c_	ribulose 5-phosphate 3-epimerase	True
RPI	r5p_c_ <=> ru5p_D_c_	ribose-5-phosphate isomerase	True
S7PI	s7p_c_ <=> gmhep7p_c_	sedoheptulose 7-phosphate isomerase	False
SADT2	atp_c_ + gtp_c_ + h2o_c_ + so4_c_ <=> aps_c_ + gdp_c_ + pi_c_ + ppi_c_	Sulfate adenyltransferase	False
SDPDS	h2o_c_ + sl26da_c_ <=> _26dap_LL_c_ + succ_c_	succinyl-diaminopimelate desuccinylase	False
SDPTA	akg_c_ + sl26da_c_ <=> glu_L_c_ + sl2a6o_c_	succinyldiaminopimelate transaminase	True
SERASr	atp_c_ + h_c_ + ser_L_c_ <=> ppi_c_ + seramp_c_	(L-seryl)adenylate synthase	True
SERAT	accoa_c_ + ser_L_c_ <=> acser_c_ + coa_c_	serine O-acetyltransferase	True
SERD_L	ser_L_c_ <=> nh4_c_ + pyr_c_	L-serine deaminase	False
SHCHD2	dscl_c_ + nad_c_ <=> h_c_ + nadh_c_ + scl_c_	sirohydrochlorin dehydrogenase (NAD)	False
SHCHF	fe2_c_ + scl_c_ <=> 3 h_c_ + sheme_c_	sirohydrochlorin ferrochetalase	False
SHK3Dr	_3dhsk_c_ + h_c_ + nadph_c_ <=> nadp_c_ + skm_c_	shikimate dehydrogenase	True
SHKK	atp_c_ + skm_c_ <=> adp_c_ + h_c_ + skm5p_c_	shikimate kinase	False
SHSL1	cys_L_c_ + suchms_c_ <=> cyst_L_c_ + h_c_ + succ_c_	O-succinylhomoserine lyase (L-cysteine)	False
SO4tex	so4_e_ <=> so4_p_	sulfate transport via diffusion (extracellular to periplasm)	True
SUCDi	q8_c_ + succ_c_ <=> fum_c_ + q8h2_c_	succinate dehydrogenase (irreversible)	False
SUCOAS	atp_c_ + coa_c_ + succ_c_ <=> adp_c_ + pi_c_ + succoa_c_	succinyl-CoA synthetase (ADP-forming)	True
SULRi	5 h_c_ + 3 nadph_c_ + so3_c_ <=> 3 h2o_c_ + h2s_c_ + 3 nadp_c_	sulfite reductase (NADPH2)	False
SULabcpp	atp_c_ + h2o_c_ + so4_p_ <=> adp_c_ + h_c_ + pi_c_ + so4_c_	sulfate transport via ABC system (periplasm)	False
T2DECAI	tdec2eACP_c_ <=> cdec3eACP_c_	trans-2-decenoyl-ACP isomerase	True
TALA	g3p_c_ + s7p_c_ <=> e4p_c_ + f6p_c_	transaldolase	True
TDPDRE	dtdp4d6dg_c_ <=> dtdp4d6dm_c_	dTDP-4-dehydrorhamnose 3,5-epimerase	False
TDPDRR	dtdp4d6dm_c_ + h_c_ + nadph_c_ <=> dtdprmn_c_ + nadp_c_	dTDP-4-dehydrorhamnose reductase	False
TDPGDH	dtdpglu_c_ <=> dtdp4d6dg_c_ + h2o_c_	dTDPglucose 4,6-dehydratase	False
TDSK	atp_c_ + lipidAds_c_ <=> adp_c_ + h_c_ + lipidA_c_	Tetraacyldisaccharide 4'kinase	False
THD2pp	2 h_p_ + nadh_c_ + nadp_c_ <=> 2 h_c_ + nad_c_ + nadph_c_	NAD(P) transhydrogenase (periplasm)	False
THDPS	h2o_c_ + succoa_c_ + thdp_c_ <=> coa_c_ + sl2a6o_c_	tetrahydrodipicolinate succinylase	False
THIORDXi	h2o2_c_ + trdrd_c_ <=> 2 h2o_c_ + trdox_c_	hydrogen peroxide reductase (thioredoxin)	False
THRAi	thr_L_c_ <=> acald_c_ + gly_c_	Threonine aldolase	False
THRD	nad_c_ + thr_L_c_ <=> _2aobut_c_ + h_c_ + nadh_c_	L-threonine dehydrogenase	False
THRD_L	thr_L_c_ <=> _2obut_c_ + nh4_c_	L-threonine deaminase	False
THRS	h2o_c_ + phom_c_ <=> pi_c_ + thr_L_c_	threonine synthase	False
THZPSN	atp_c_ + cys_L_c_ + dxyl5p_c_ + tyr_L_c_ <=> _4hba_c_ + _4mpetz_c_ + ala_L_c_ + amp_c_ + co2_c_ + h2o_c_ + h_c_ + ppi_c_	thiazole phosphate synthesis	False
TKT1	r5p_c_ + xu5p_D_c_ <=> g3p_c_ + s7p_c_	transketolase	True
TKT2	e4p_c_ + xu5p_D_c_ <=> f6p_c_ + g3p_c_	transketolase	True
TMDS	dump_c_ + mlthf_c_ <=> dhf_c_ + dtmp_c_	thymidylate synthase	False
TMPK	atp_c_ + thmmp_c_ <=> adp_c_ + thmpp_c_	thiamine-phosphate kinase	False
TMPPP	_2mahmp_c_ + _4mpetz_c_ + h_c_ <=> ppi_c_ + thmmp_c_	thiamine-phosphate diphosphorylase	False
TPI	dhap_c_ <=> g3p_c_	triose-phosphate isomerase	True
TRDR	h_c_ + nadph_c_ + trdox_c_ <=> nadp_c_ + trdrd_c_	thioredoxin reductase (NADPH)	False
TRPS2	indole_c_ + ser_L_c_ <=> h2o_c_ + trp_L_c_	tryptophan synthase (indole)	False
TRPS3	_3ig3p_c_ <=> g3p_c_ + indole_c_	tryptophan synthase (indoleglycerol phosphate)	False
TRSARr	_2h3oppan_c_ + h_c_ + nadh_c_ <=> glyc_R_c_ + nad_c_	tartronate semialdehyde reductase	True
TYRTA	akg_c_ + tyr_L_c_ <=> _34hpp_c_ + glu_L_c_	tyrosine transaminase	True
U23GAAT	_3hmrsACP_c_ + u3hga_c_ <=> ACP_c_ + h_c_ + u23ga_c_	UDP-3-O-(3-hydroxymyristoyl)glucosamine acyltransferase	False
UAAGDS	_26dap_M_c_ + atp_c_ + uamag_c_ <=> adp_c_ + h_c_ + pi_c_ + ugmd_c_	UDP-N-acetylmuramoyl-L-alanyl-D-glutamyl-meso-2,6-diaminopimelate synthetase	False
UAGAAT	_3hmrsACP_c_ + uacgam_c_ <=> ACP_c_ + u3aga_c_	UDP-N-acetylglucosamine acyltransferase	True
UAGCVT	pep_c_ + uacgam_c_ <=> pi_c_ + uaccg_c_	UDP-N-acetylglucosamine 1-carboxyvinyltransferase	False
UAGDP	acgam1p_c_ + h_c_ + utp_c_ <=> ppi_c_ + uacgam_c_	UDP-N-acetylglucosamine diphosphorylase	False
UAGPT3	uacgam_c_ + uagmda_c_ <=> h_c_ + uaagmda_c_ + udp_c_	UDP-N-acetylglucosamine-N-acetylmuramyl-(pentapeptide)pyrophosphoryl-undecaprenol N-acetylglucosamine transferase	False
UAMAGS	atp_c_ + glu_D_c_ + uama_c_ <=> adp_c_ + h_c_ + pi_c_ + uamag_c_	UDP-N-acetylmuramoyl-L-alanyl-D-glutamate synthetase	False
UAMAS	ala_L_c_ + atp_c_ + uamr_c_ <=> adp_c_ + h_c_ + pi_c_ + uama_c_	UDP-N-acetylmuramoyl-L-alanine synthetase	False
UAPGR	h_c_ + nadph_c_ + uaccg_c_ <=> nadp_c_ + uamr_c_	UDP-N-acetylenolpyruvoylglucosamine reductase	False
UDCPDP	h2o_c_ + udcpdp_c_ <=> h_c_ + pi_c_ + udcpp_c_	undecaprenyl-diphosphatase	False
UDCPDPS	frdp_c_ + 8 ipdp_c_ <=> 8 ppi_c_ + udcpdp_c_	Undecaprenyl diphosphate synthase	False
UDCPPtppi	udcpp_p_ <=> udcpp_c_	undecaprenyl phosphate transport (cytoplasm to periplasm)	False
UDPGD	h2o_c_ + 2 nad_c_ + udpg_c_ <=> 3 h_c_ + 2 nadh_c_ + udpglcur_c_	UDPglucose 6-dehydrogenase	False
UDPGDC	nad_c_ + udpglcur_c_ <=> co2_c_ + nadh_c_ + udpLa4o_c_	UDP-glucuronate C-4'' decarboxylase	False
UDPKAAT	glu_L_c_ + udpLa4o_c_ <=> akg_c_ + udpLa4n_c_	UDP-4''-ketopentose:UDP-4-amino-4-deoxy-L-arabinose aminotransferase	True
UGMDDS	alaala_c_ + atp_c_ + ugmd_c_ <=> adp_c_ + h_c_ + pi_c_ + ugmda_c_	UDP-N-acetylmuramoyl-L-alanyl-D-glutamyl-meso-2,6-diaminopimeloyl-D-alanyl-D-alanine synthetase	False
UHGADA	h2o_c_ + u3aga_c_ <=> ac_c_ + u3hga_c_	UDP-3-O-acetylglucosamine deacetylase	False
ULA4NFT	_10fthf_c_ + udpLa4n_c_ <=> h_c_ + thf_c_ + udpLa4fn_c_	UDP-L-Ara4N formyltransferase	False
ULA4Ntppi	uLa4n_c_ <=> uLa4n_p_	transport (cytoplasm to periplasm)	False
UM3PL	LalaDgluMdap_c_ + atp_c_ + uamr_c_ <=> adp_c_ + h_c_ + pi_c_ + ugmd_c_	UDP-N-acetylmuramate:L-alanyl-gamma-D-glutamyl-meso-diaminopimelate ligase	False
UMPK	atp_c_ + ump_c_ <=> adp_c_ + udp_c_	UMP kinase	True
UPLA4FNF	h2o_c_ + uLa4fn_c_ <=> for_c_ + uLa4n_c_	undecaprenyl phosphate-L-Ara4FN formylase	False
UPLA4FNT	udcpp_c_ + udpLa4fn_c_ <=> uLa4fn_c_ + udp_c_	undecaprenyl phosphate-L-Ara4FN transferase	False
UPP3MT	2 amet_c_ + uppg3_c_ <=> 2 ahcys_c_ + dscl_c_ + h_c_	uroporphyrinogen methyltransferase	False
UPP3S	hmbil_c_ <=> h2o_c_ + uppg3_c_	uroporphyrinogen-III synthase	False
UPPDC1	4 h_c_ + uppg3_c_ <=> 4 co2_c_ + cpppg3_c_	uroporphyrinogen decarboxylase (uroporphyrinogen III)	False
URIDK2r	atp_c_ + dump_c_ <=> adp_c_ + dudp_c_	uridylate kinase (dUMP)	True
URIK2	gtp_c_ + uri_c_ <=> gdp_c_ + h_c_ + ump_c_	uridine kinase (GTP:Uridine)	False
USHD	h2o_c_ + u23ga_c_ <=> 2 h_c_ + lipidX_c_ + ump_c_	UDP-sugar hydrolase	False
VALTA	akg_c_ + val_L_c_ <=> _3mob_c_ + glu_L_c_	valine transaminase	True
XYLI2	glc_D_c_ <=> fru_c_	xylose isomerase	True
ZN2tpp	zn2_p_ <=> zn2_c_	zinc transport in via permease (no H+)	False
Zn2tex	zn2_e_ <=> zn2_p_	zinc (Zn+2) transport via diffusion (extracellular to periplasm)	True
%			
!!SBtab TableName='Compound' TableType='Compound' Document='Model' SBtabVersion='0.9'			
!ID	!Name	!IsConstant	
_10fthf_c_	10-Formyltetrahydrofolate	False	
_13dpg_c_	3-Phospho-D-glyceroyl phosphate	False	
_1ddecg3p_c_	1-dodecanoyl-sn-glycerol 3-phosphate	False	
_1ddecg3p_p_	1-dodecanoyl-sn-glycerol 3-phosphate	False	
_1hdec9eg3p_c_	1-hexadec-9-enoyl-sn-glycerol 3-phosphate	False	
_1hdecg3p_c_	1-hexadecanoyl-sn-glycerol 3-phosphate	False	
_1pyr5c_c_	1-Pyrroline-5-carboxylate	False	
_23ddhb_c_	2,3-Dihydro-2,3-dihydroxybenzoate	False	
_23dhb_c_	2,3-Dihydroxybenzoate	False	
_23dhba_c_	(2,3-Dihydroxybenzoyl)adenylate	False	
_23dhdp_c_	2,3-Dihydrodipicolinate	False	
_23dhmb_c_	(R)-2,3-Dihydroxy-3-methylbutanoate	False	
_23dhmp_c_	(R)-2,3-Dihydroxy-3-methylpentanoate	False	
_25aics_c_	(S)-2-[5-Amino-1-(5-phospho-D-ribosyl)imidazole-4-carboxamido]succinate	False	
_25drapp_c_	2,5-Diamino-6-(ribosylamino)-4-(3H)-pyrimidinone 5'-phosphate	False	
_26dap_LL_c_	LL-2,6-Diaminoheptanedioate	False	
_26dap_M_c_	meso-2,6-Diaminoheptanedioate	False	
_2ahbut_c_	(S)-2-Aceto-2-hydroxybutanoate	False	
_2aobut_c_	L-2-Amino-3-oxobutanoate	False	
_2cpr5p_c_	1-(2-Carboxyphenylamino)-1-deoxy-D-ribulose 5-phosphate	False	
_2dda7p_c_	2-Dehydro-3-deoxy-D-arabino-heptonate 7-phosphate	False	
_2dhp_c_	2-Dehydropantoate	False	
_2dr1p_c_	2-Deoxy-D-ribose 1-phosphate	False	
_2h3oppan_c_	2-Hydroxy-3-oxopropanoate	False	
_2ippm_c_	2-Isopropylmaleate	False	
_2mahmp_c_	2-Methyl-4-amino-5-hydroxymethylpyrimidine diphosphate	False	
_2mcacn_c_	cis-2-Methylaconitate	False	
_2mcit_c_	2-Methylcitrate	False	
_2me4p_c_	2-C-methyl-D-erythritol 4-phosphate	False	
_2mecdp_c_	2-C-methyl-D-erythritol 2,4-cyclodiphosphate	False	
_2obut_c_	2-Oxobutanoate	False	
_2ohph_c_	2-Octaprenyl-6-hydroxyphenol	False	
_2oph_c_	2-Octaprenylphenol	False	
_2p4c2me_c_	2-phospho-4-(cytidine 5'-diphospho)-2-C-methyl-D-erythritol	False	
_2pg_c_	D-Glycerate 2-phosphate	False	
_34hpp_c_	3-(4-Hydroxyphenyl)pyruvate	False	
_3c2hmp_c_	3-Carboxy-2-hydroxy-4-methylpentanoate	False	
_3c3hmp_c_	3-Carboxy-3-hydroxy-4-methylpentanoate	False	
_3c4mop_c_	3-Carboxy-4-methyl-2-oxopentanoate	False	
_3dhq_c_	3-Dehydroquinate	False	
_3dhsk_c_	3-Dehydroshikimate	False	
_3haACP_c_	(3R)-3-Hydroxyacyl-[acyl-carrier protein]	False	
_3hbcoa_c_	(S)-3-Hydroxybutanoyl-CoA	False	
_3hcddec5eACP_c_	(R)-3-hydroxy-cis-dodec-5-enoyl-[acyl-carrier protein]	False	
_3hcmrs7eACP_c_	(R)-3-hydroxy-cis-myristol-7-eoyl-[acyl-carrier protein]	False	
_3hcpalm9eACP_c_	(R)-3-hydroxy-cis-palm-9-eoyl-[acyl-carrier protein]	False	
_3hdcoa_c_	(S)-3-Hydroxydecanoyl-CoA	False	
_3hddcoa_c_	(S)-3-Hydroxydodecanoyl-CoA	False	
_3hddecACP_c_	(R)-3-Hydroxydodecanoyl-[acyl-carrier protein]	False	
_3hdecACP_c_	(R)-3-Hydroxydecanoyl-[acyl-carrier protein]	False	
_3hhcoa_c_	(S)-3-Hydroxyhexanoyl-CoA	False	
_3hhexACP_c_	(R)-3-Hydroxyhexanoyl-[acyl-carrier protein]	False	
_3hmrsACP_c_	(R)-3-Hydroxytetradecanoyl-[acyl-carrier protein]	False	
_3hocoa_c_	(S)-3-Hydroxyoctanoyl-CoA	False	
_3hoctACP_c_	(R)-3-Hydroxyoctanoyl-[acyl-carrier protein]	False	
_3hpalmACP_c_	R-3-hydroxypalmitoyl-[acyl-carrier protein]	False	
_3ig3p_c_	C'-(3-Indolyl)-glycerol 3-phosphate	False	
_3mob_c_	3-Methyl-2-oxobutanoate	False	
_3mop_c_	(S)-3-Methyl-2-oxopentanoate	False	
_3ocddec5eACP_c_	3-oxo-cis-dodec-5-enoyl-[acyl-carrier protein]	False	
_3ocmrs7eACP_c_	3-oxo-cis-myristol-7-eoyl-[acyl-carrier protein]	False	
_3ocpalm9eACP_c_	3-oxo-cis-palm-9-eoyl-[acyl-carrier protein]	False	
_3odcoa_c_	3-Oxodecanoyl-CoA	False	
_3oddcoa_c_	3-Oxododecanoyl-CoA	False	
_3oddecACP_c_	3-Oxododecanoyl-[acyl-carrier protein]	False	
_3odecACP_c_	3-Oxodecanoyl-[acyl-carrier protein]	False	
_3ohcoa_c_	3-Oxohexanoyl-CoA	False	
_3ohexACP_c_	3-Oxohexanoyl-[acyl-carrier protein]	False	
_3omrsACP_c_	3-Oxotetradecanoyl-[acyl-carrier protein]	False	
_3oocoa_c_	3-Oxooctanoyl-CoA	False	
_3ooctACP_c_	3-Oxooctanoyl-[acyl-carrier protein]	False	
_3opalmACP_c_	3-Oxohexadecanoyl-[acyl-carrier protein]	False	
_3ophb_c_	3-Octaprenyl-4-hydroxybenzoate	False	
_3pg_c_	3-Phospho-D-glycerate	False	
_3php_c_	3-Phosphohydroxypyruvate	False	
_3psme_c_	5-O-(1-Carboxyvinyl)-3-phosphoshikimate	False	
_4abz_c_	4-Aminobenzoate	False	
_4adcho_c_	4-amino-4-deoxychorismate	False	
_4ampm_c_	4-Amino-2-methyl-5-phosphomethylpyrimidine	False	
_4c2me_c_	4-(cytidine 5'-diphospho)-2-C-methyl-D-erythritol	False	
_4hba_c_	4-Hydroxy-benzyl alcohol	False	
_4hbz_c_	4-Hydroxybenzoate	False	
_4mop_c_	4-Methyl-2-oxopentanoate	False	
_4mpetz_c_	4-Methyl-5-(2-phosphoethyl)-thiazole	False	
_4pasp_c_	4-Phospho-L-aspartate	False	
_4per_c_	4-Phospho-D-erythronate	False	
_4ppan_c_	D-4'-Phosphopantothenate	False	
_4ppcys_c_	N-((R)-4-Phosphopantothenoyl)-L-cysteine	False	
_4r5au_c_	4-(1-D-Ribitylamino)-5-aminouracil	False	
_5aizc_c_	5-amino-1-(5-phospho-D-ribosyl)imidazole-4-carboxylate	False	
_5aop_c_	5-Amino-4-oxopentanoate	False	
_5aprbu_c_	5-Amino-6-(5'-phosphoribitylamino)uracil	False	
_5apru_c_	5-Amino-6-(5'-phosphoribosylamino)uracil	False	
_5caiz_c_	5-phosphoribosyl-5-carboxyaminoimidazole	False	
_5dglcn_c_	5-Dehydro-D-gluconate	False	
_5drib_c_	5'-deoxyribose	False	
_5mthf_c_	5-Methyltetrahydrofolate	False	
_6hmhpt_c_	6-hydroxymethyl dihydropterin	False	
_6hmhptpp_c_	6-hydroxymethyl-dihydropterin pyrophosphate	False	
_6pgc_c_	6-Phospho-D-gluconate	False	
_6pgl_c_	6-phospho-D-glucono-1,5-lactone	False	
ACP_c_	acyl carrier protein	False	
LalaDgluMdap_c_	L-alanine-D-glutamate-meso-2,6-diaminoheptanedioate	False	
LalaDgluMdap_p_	L-alanine-D-glutamate-meso-2,6-diaminoheptanedioate	False	
aacoa_c_	Acetoacetyl-CoA	False	
ac_c_	Acetate	False	
ac_e_	Acetate	True	
ac_p_	Acetate	False	
acald_c_	Acetaldehyde	False	
acald_e_	Acetaldehyde	True	
acald_p_	Acetaldehyde	False	
accoa_c_	Acetyl-CoA	False	
acg5p_c_	N-Acetyl-L-glutamyl 5-phosphate	False	
acg5sa_c_	N-Acetyl-L-glutamate 5-semialdehyde	False	
acgam1p_c_	N-Acetyl-D-glucosamine 1-phosphate	False	
acgam6p_c_	N-Acetyl-D-glucosamine 6-phosphate	False	
acgam_c_	N-Acetyl-D-glucosamine	False	
acglu_c_	N-Acetyl-L-glutamate	False	
acmum6p_c_	N-acetylmuramate 6-phosphate	False	
acolipa_e_	4-Amino-4-deoxy-L-arabinose modified core oligosaccharide lipid A	True	
acolipa_p_	4-Amino-4-deoxy-L-arabinose modified core oligosaccharide lipid A	False	
acon_C_c_	cis-Aconitate	False	
acorn_c_	N2-Acetyl-L-ornithine	False	
acser_c_	O-Acetyl-L-serine	False	
actACP_c_	Acetoacetyl-ACP	False	
actp_c_	Acetyl phosphate	False	
ade_c_	Adenine	False	
adn_c_	Adenosine	False	
adp_c_	ADP	False	
adpglc_c_	ADPglucose	False	
adphep_DD_c_	ADP-D-glycero-D-manno-heptose	False	
adphep_LD_c_	ADP-L-glycero-D-manno-heptose	False	
adprib_c_	ADPribose	False	
ahcys_c_	S-Adenosyl-L-homocysteine	False	
ahdt_c_	2-Amino-4-hydroxy-6-(erythro-1,2,3-trihydroxypropyl)dihydropteridine triphosphate	False	
aicar_c_	5-Amino-1-(5-Phospho-D-ribosyl)imidazole-4-carboxamide	False	
air_c_	5-amino-1-(5-phospho-D-ribosyl)imidazole	False	
akg_c_	2-Oxoglutarate	False	
ala_B_c_	beta-Alanine	False	
ala_D_c_	D-Alanine	False	
ala_D_p_	D-Alanine	False	
ala_L_c_	L-Alanine	False	
alaala_c_	D-Alanyl-D-alanine	False	
alaala_p_	D-Alanyl-D-alanine	False	
alac_S_c_	(S)-2-Acetolactate	False	
amet_c_	S-Adenosyl-L-methionine	False	
amp_c_	AMP	False	
anhgm3p_c_	N-Acetyl-D-glucosamine(anhydrous)N-Acetylmuramyl-tripeptide	False	
anhgm3p_p_	N-Acetyl-D-glucosamine(anhydrous)N-Acetylmuramyl-tripeptide	False	
anhgm4p_c_	N-Acetyl-D-glucosamine(anhydrous)N-Acetylmuramyl-tetrapeptide	False	
anhgm4p_p_	N-Acetyl-D-glucosamine(anhydrous)N-Acetylmuramyl-tetrapeptide	False	
anhgm_e_	N-Acetyl-D-glucosamine(anhydrous)N-Acetylmuramic acid	True	
anhgm_p_	N-Acetyl-D-glucosamine(anhydrous)N-Acetylmuramic acid	False	
anhm3p_c_	1,6-anhydrous-N-Acetylmuramyl-tripeptide	False	
anhm_c_	1,6-anhydrous-N-Acetylmuramate	False	
anth_c_	Anthranilate	False	
aps_c_	Adenosine 5'-phosphosulfate	False	
ara5p_c_	D-Arabinose 5-phosphate	False	
arg_L_c_	L-Arginine	False	
arg_L_e_	L-Arginine	True	
arg_L_p_	L-Arginine	False	
argsuc_c_	N(omega)-(L-Arginino)succinate	False	
asn_L_c_	L-Asparagine	False	
asp_L_c_	L-Aspartate	False	
aspsa_c_	L-Aspartate 4-semialdehyde	False	
atp_c_	ATP	False	
b2coa_c_	Crotonoyl-CoA	False	
btcoa_c_	Butanoyl-CoA	False	
but2eACP_c_	But-2-enoyl-[acyl-carrier protein]	False	
butACP_c_	Butyryl-ACP (n-C4:0ACP)	False	
ca2_c_	Calcium	False	
ca2_e_	Calcium	True	
ca2_p_	Calcium	False	
camp_c_	cAMP	False	
cbasp_c_	N-Carbamoyl-L-aspartate	False	
cbp_c_	Carbamoyl phosphate	False	
cddec5eACP_c_	cis-dodec-5-enoyl-[acyl-carrier protein] (n-C12:1)	False	
cdec3eACP_c_	cis-dec-3-enoyl-[acyl-carrier protein] (n-C10:1)	False	
cdp_c_	CDP	False	
cdpdhdec9eg_c_	CDP-1,2-dihexadec-9-enoylglycerol	False	
cdpdhdecg_c_	CDP-1,2-dihexadecanoylglycerol	False	
chor_c_	chorismate	False	
cit_c_	Citrate	False	
citr_L_c_	L-Citrulline	False	
ckdo_c_	CMP-3-deoxy-D-manno-octulosonate	False	
cl_c_	Chloride	False	
cl_e_	Chloride	True	
cl_p_	Chloride	False	
cmp_c_	CMP	False	
co2_c_	CO2	False	
co2_e_	CO2	True	
co2_p_	CO2	False	
coa_c_	Coenzyme A	False	
cobalt2_c_	Co2+	False	
cobalt2_e_	Co2+	True	
cobalt2_p_	Co2+	False	
colipa_c_	core oligosaccharide lipid A	False	
colipa_p_	core oligosaccharide lipid A	False	
cpppg3_c_	Coproporphyrinogen III	False	
crn_c_	L-Carnitine	False	
crn_p_	L-Carnitine	False	
csn_c_	Cytosine	False	
ctp_c_	CTP	False	
cu2_c_	Cu2+	False	
cu2_e_	Cu2+	True	
cu2_p_	Cu2+	False	
cys_L_c_	L-Cysteine	False	
cyst_L_c_	L-Cystathionine	False	
cytd_c_	Cytidine	False	
dad_2_c_	Deoxyadenosine	False	
dad_5_c_	5'-Deoxyadenosine	False	
dadp_c_	dADP	False	
damp_c_	dAMP	False	
datp_c_	dATP	False	
db4p_c_	3,4-dihydroxy-2-butanone 4-phosphate	False	
dc2coa_c_	trans-Dec-2-enoyl-CoA	False	
dcaACP_c_	Decanoyl-ACP (n-C10:0ACP)	False	
dcacoa_c_	Decanoyl-CoA (n-C10:0CoA)	False	
dcamp_c_	N6-(1,2-Dicarboxyethyl)-AMP	False	
dcdp_c_	dCDP	False	
dcmp_c_	dCMP	False	
dctp_c_	dCTP	False	
dd2coa_c_	trans-Dodec-2-enoyl-CoA	False	
ddcaACP_c_	Dodecanoyl-ACP (n-C12:0ACP)	False	
ddca_p_	Dodecanoate (n-C12:0)	False	
ddcacoa_c_	Dodecanoyl-CoA (n-C12:0CoA)	False	
dgdp_c_	dGDP	False	
dgmp_c_	dGMP	False	
dgsn_c_	Deoxyguanosine	False	
dgtp_c_	dGTP	False	
dhap_c_	Dihydroxyacetone phosphate	False	
dhf_c_	7,8-Dihydrofolate	False	
dhnpt_c_	Dihydroneopterin	False	
dhor_S_c_	(S)-Dihydroorotate	False	
dhpmp_c_	Dihydroneopterin monophosphate	False	
dhpt_c_	Dihydropteroate	False	
dhptd_c_	4,5-dihydroxy-2,3-pentanedione	False	
dmlz_c_	6,7-Dimethyl-8-(1-D-ribityl)lumazine	False	
dmpp_c_	Dimethylallyl diphosphate	False	
dnad_c_	Deamino-NAD+	False	
dpcoa_c_	Dephospho-CoA	False	
dscl_c_	dihydrosirohydrochlorin	False	
dtdp4d6dg_c_	dTDP-4-dehydro-6-deoxy-D-glucose	False	
dtdp4d6dm_c_	dTDP-4-dehydro-6-deoxy-L-mannose	False	
dtdp_c_	dTDP	False	
dtdpglu_c_	dTDPglucose	False	
dtdprmn_c_	dTDP-L-rhamnose	False	
dtmp_c_	dTMP	False	
dttp_c_	dTTP	False	
dudp_c_	dUDP	False	
dump_c_	dUMP	False	
duri_c_	Deoxyuridine	False	
dxyl5p_c_	1-deoxy-D-xylulose 5-phosphate	False	
e4p_c_	D-Erythrose 4-phosphate	False	
eig3p_c_	D-erythro-1-(Imidazol-4-yl)glycerol 3-phosphate	False	
enter_c_	Enterochelin	False	
enter_e_	Enterochelin	True	
enter_p_	Enterochelin	False	
etoh_c_	Ethanol	False	
etoh_e_	Ethanol	True	
etoh_p_	Ethanol	False	
f6p_c_	D-Fructose 6-phosphate	False	
fad_c_	Flavin adenine dinucleotide oxidized	False	
fadh2_c_	Flavin adenine dinucleotide reduced	False	
fdp_c_	D-Fructose 1,6-bisphosphate	False	
fe2_c_	Fe2+	False	
fe2_e_	Fe2+	True	
fe2_p_	Fe2+	False	
fe3_c_	Fe3+	False	
fe3_e_	Fe3+	True	
fe3_p_	Fe3+	False	
fgam_c_	N2-Formyl-N1-(5-phospho-D-ribosyl)glycinamide	False	
fldox_c_	flavodoxin (oxidized)	False	
fldrd_c_	flavodoxin (reduced)	False	
fmn_c_	FMN	False	
for_c_	Formate	False	
for_e_	Formate	True	
for_p_	Formate	False	
fpram_c_	2-(Formamido)-N1-(5-phospho-D-ribosyl)acetamidine	False	
fprica_c_	5-Formamido-1-(5-phospho-D-ribosyl)imidazole-4-carboxamide	False	
frdp_c_	Farnesyl diphosphate	False	
fru_c_	D-Fructose	False	
fum_c_	Fumarate	False	
g1p_c_	D-Glucose 1-phosphate	False	
g3p_c_	Glyceraldehyde 3-phosphate	False	
g6p_c_	D-Glucose 6-phosphate	False	
gagicolipa_c_	galactosyl-glucosyl-inner core oligosaccharide lipid A	False	
gam1p_c_	D-Glucosamine 1-phosphate	False	
gam6p_c_	D-Glucosamine 6-phosphate	False	
gar_c_	N1-(5-Phospho-D-ribosyl)glycinamide	False	
gcald_c_	Glycolaldehyde	False	
gdp_c_	GDP	False	
ggagicolipa_c_	glucosyl-galactosyl-glucosyl-inner core oligosaccharide lipid A	False	
gggagicolipa_c_	glucosyl-glucosyl-galactosyl-glucosyl-inner core oligosaccharide lipid A	False	
gicolipa_c_	glucosyl-inner core oligosaccharide lipid A	False	
glc_D_c_	D-Glucose	False	
glc_D_e_	D-Glucose	True	
glc_D_p_	D-Glucose	False	
glcn_c_	D-Gluconate	False	
glcn_p_	D-Gluconate	False	
gln_L_c_	L-Glutamine	False	
glu1sa_c_	L-Glutamate 1-semialdehyde	False	
glu5p_c_	L-Glutamate 5-phosphate	False	
glu5sa_c_	L-Glutamate 5-semialdehyde	False	
glu_D_c_	D-Glutamate	False	
glu_L_c_	L-Glutamate	False	
glutrna_c_	L-Glutamyl-tRNA(Glu)	False	
glx_c_	Glyoxylate	False	
gly_c_	Glycine	False	
glyc3p_c_	Glycerol 3-phosphate	False	
glyc3p_p_	Glycerol 3-phosphate	False	
glyc_R_c_	(R)-Glycerate	False	
glyclt_c_	Glycolate	False	
glycogen_c_	glycogen	False	
gmhep17bp_c_	D-Glycero-D-manno-heptose 1,7-bisphosphate	False	
gmhep1p_c_	D-Glycero-D-manno-heptose 1-phosphate	False	
gmhep7p_c_	D-Glycero-D-manno-heptose 7-phosphate	False	
gmp_c_	GMP	False	
grdp_c_	Geranyl diphosphate	False	
grxox_c_	glutaredoxin (oxidized)	False	
grxrd_c_	glutaredoxin (reduced)	False	
gsn_c_	Guanosine	False	
gthox_c_	Oxidized glutathione	False	
gthrd_c_	Reduced glutathione	False	
gtp_c_	GTP	False	
gua_c_	Guanine	False	
h2mb4p_c_	1-hydroxy-2-methyl-2-(E)-butenyl 4-diphosphate	False	
h2o2_c_	Hydrogen peroxide	False	
h2o_c_	H2O	False	
h2o_e_	H2O	True	
h2o_p_	H2O	False	
h2s_c_	Hydrogen sulfide	False	
h2s_e_	Hydrogen sulfide	True	
h2s_p_	Hydrogen sulfide	False	
h_c_	H+	True	
h_p_	H+	True	
hco3_c_	Bicarbonate	False	
hcys_L_c_	L-Homocysteine	False	
hdeACP_c_	cis-hexadec-9-enoyl-[acyl-carrier protein] (n-C16:1)	False	
hexACP_c_	Hexanoyl-ACP (n-C6:0ACP)	False	
hhlipa_c_	heptosyl-heptosyl-kdo2-lipidA	False	
his_L_c_	L-Histidine	False	
hisp_c_	L-Histidinol phosphate	False	
histd_c_	L-Histidinol	False	
hlipa_c_	heptosyl-kdo2-lipidA	False	
hmbil_c_	Hydroxymethylbilane	False	
hmfurn_c_	4-hydroxy-5-methyl-3(2H)-furanone	False	
hom_L_c_	L-Homoserine	False	
hphhlipa_c_	heptosyl-phospho-heptosyl-heptosyl-kdo2-lipidA	False	
hpyr_c_	Hydroxypyruvate	False	
hx2coa_c_	trans-Hex-2-enoyl-CoA	False	
hxa_c_	Hexanoate (n-C6:0)	False	
hxcoa_c_	Hexanoyl-CoA (n-C6:0CoA)	False	
iasp_c_	Iminoaspartate	False	
ichor_c_	Isochorismate	False	
icit_c_	Isocitrate	False	
icolipa_c_	inner core oligosaccharide lipid A (E coli)	False	
idon_L_c_	L-Idonate	False	
idon_L_e_	L-Idonate	True	
idon_L_p_	L-Idonate	False	
idp_c_	IDP	False	
ile_L_c_	L-Isoleucine	False	
imacp_c_	3-(Imidazol-4-yl)-2-oxopropyl phosphate	False	
imp_c_	IMP	False	
indole_c_	Indole	False	
ipdp_c_	Isopentenyl diphosphate	False	
itp_c_	ITP	False	
k_c_	potassium	False	
k_e_	potassium	True	
k_p_	potassium	False	
kdo2lipid4L_c_	KDO(2)-lipid IV(A) with laurate	False	
kdo2lipid4_c_	KDO(2)-lipid IV(A)	False	
kdo2lipid4_e_	KDO(2)-lipid IV(A)	True	
kdo2lipid4_p_	KDO(2)-lipid IV(A)	False	
kdo8p_c_	3-Deoxy-D-manno-octulosonate 8-phosphate	False	
kdo_c_	3-Deoxy-D-manno-2-octulosonate	False	
kdolipid4_c_	KDO-lipid IV(A)	False	
kphphhlipa_c_	kdo-phospho-heptosyl-phospho-heptosyl-heptosyl-kdo2-lipidA	False	
lac_D_c_	D-Lactate	False	
leu_L_c_	L-Leucine	False	
lipa_c_	KDO(2)-lipid (A)	False	
lipidA_c_	2,3,2'3'-Tetrakis(beta-hydroxymyristoyl)-D-glucosaminyl-1,6-beta-D-glucosamine 1,4'-bisphosphate	False	
lipidAds_c_	Lipid A Disaccharide	False	
lipidX_c_	2,3-Bis(3-hydroxytetradecanoyl)-beta-D-glucosaminyl 1-phosphate	False	
lys_L_c_	L-Lysine	False	
malACP_c_	Malonyl-[acyl-carrier protein]	False	
mal_L_c_	L-Malate	False	
malcoa_c_	Malonyl-CoA	False	
met_L_c_	L-Methionine	False	
methf_c_	5,10-Methenyltetrahydrofolate	False	
mg2_c_	magnesium	False	
mg2_e_	magnesium	True	
mg2_p_	magnesium	False	
micit_c_	methylisocitrate	False	
mlthf_c_	5,10-Methylenetetrahydrofolate	False	
mn2_c_	Mn2+	False	
mn2_e_	Mn2+	True	
mn2_p_	Mn2+	False	
mobd_c_	Molybdate-MoO4	False	
mobd_e_	Molybdate-MoO4	True	
mobd_p_	Molybdate-MoO4	False	
mql8_c_	Menaquinol 8	False	
mqn8_c_	Menaquinone 8	False	
murein4p3p_p_	two linked disacharide tetrapeptide and tripeptide murein units (uncrosslinked, middle of chain)	False	
murein4p4p_p_	two linked disacharide tetrapeptide murein units (uncrosslinked, middle of chain)	False	
murein5p3p_p_	two linked disacharide pentapeptide and tripeptide murein units (uncrosslinked, middle of chain)	False	
murein5p4p_p_	two linked disacharide pentapeptide and tetrapeptide murein units (uncrosslinked, middle of chain)	False	
murein5p5p_p_	two linked disacharide pentapeptide murein units (uncrosslinked, middle of chain)	False	
murein5px4p_p_	two disacharide linked murein units, pentapeptide crosslinked tetrapeptide (A2pm->D-ala) (middle of chain)	False	
myrsACP_c_	Myristoyl-ACP (n-C14:0ACP)	False	
na1_c_	Sodium	False	
na1_p_	Sodium	False	
nac_c_	Nicotinate	False	
nad_c_	Nicotinamide adenine dinucleotide	False	
nadh_c_	Nicotinamide adenine dinucleotide - reduced	False	
nadp_c_	Nicotinamide adenine dinucleotide phosphate	False	
nadph_c_	Nicotinamide adenine dinucleotide phosphate - reduced	False	
ncam_c_	Nicotinamide	False	
nh4_c_	Ammonium	False	
nh4_e_	Ammonium	True	
nh4_p_	Ammonium	False	
nicrnt_c_	Nicotinate D-ribonucleotide	False	
o2_c_	O2	False	
o2_e_	O2	True	
o2_p_	O2	False	
oaa_c_	Oxaloacetate	False	
oc2coa_c_	trans-Oct-2-enoyl-CoA	False	
ocACP_c_	Octanoyl-ACP (n-C8:0ACP)	False	
occoa_c_	Octanoyl-CoA (n-C8:0CoA)	False	
octdp_c_	all-trans-Octaprenyl diphosphate	False	
ohpb_c_	2-Oxo-3-hydroxy-4-phosphobutanoate	False	
orn_c_	Ornithine	False	
orot5p_c_	Orotidine 5'-phosphate	False	
orot_c_	Orotate	False	
pa120_c_	1,2-didodecanoyl-sn-glycerol 3-phosphate	False	
pa120_p_	1,2-didodecanoyl-sn-glycerol 3-phosphate	False	
pa160_c_	1,2-dihexadecanoyl-sn-glycerol 3-phosphate	False	
pa161_c_	1,2-dihexadec-9-enoyl-sn-glycerol 3-phosphate	False	
palmACP_c_	Palmitoyl-ACP (n-C16:0ACP)	False	
pan4p_c_	Pantetheine 4'-phosphate	False	
pant_R_c_	(R)-Pantoate	False	
pap_c_	Adenosine 3',5'-bisphosphate	False	
paps_c_	3'-Phosphoadenylyl sulfate	False	
pdx5p_c_	Pyridoxine 5'-phosphate	False	
pe160_c_	phosphatidylethanolamine (dihexadecanoyl, n-C16:0)	False	
pe160_p_	phosphatidylethanolamine (dihexadecanoyl, n-C16:0)	False	
pe161_c_	phosphatidylethanolamine (dihexadec-9enoyl, n-C16:1)	False	
pe161_p_	phosphatidylethanolamine (dihexadec-9enoyl, n-C16:1)	False	
pep_c_	Phosphoenolpyruvate	False	
phe_L_c_	L-Phenylalanine	False	
pheme_c_	Protoheme	False	
phhlipa_c_	phospho-heptosyl-heptosyl-kdo2-lipidA	False	
phom_c_	O-Phospho-L-homoserine	False	
phphhlipa_c_	phospho-heptosyl-phospho-heptosyl-heptosyl-kdo2-lipidA	False	
phpyr_c_	Phenylpyruvate	False	
phthr_c_	O-Phospho-4-hydroxy-L-threonine	False	
pi_c_	Phosphate	False	
pi_e_	Phosphate	True	
pi_p_	Phosphate	False	
pnto_R_c_	(R)-Pantothenate	False	
ppbng_c_	Porphobilinogen	False	
ppcoa_c_	Propanoyl-CoA	False	
pphn_c_	Prephenate	False	
ppi_c_	Diphosphate	False	
ppp9_c_	Protoporphyrin	False	
pppg9_c_	Protoporphyrinogen IX	False	
pram_c_	5-Phospho-beta-D-ribosylamine	False	
pran_c_	N-(5-Phospho-D-ribosyl)anthranilate	False	
prbamp_c_	1-(5-Phosphoribosyl)-AMP	False	
prbatp_c_	1-(5-Phosphoribosyl)-ATP	False	
prfp_c_	1-(5-Phosphoribosyl)-5-[(5-phosphoribosylamino)methylideneamino]imidazole-4-carboxamide	False	
prlp_c_	5-[(5-phospho-1-deoxyribulos-1-ylamino)methylideneamino]-1-(5-phosphoribosyl)imidazole-4-carboxamide	False	
pro_L_c_	L-Proline	False	
pro_L_e_	L-Proline	True	
pro_L_p_	L-Proline	False	
prpp_c_	5-Phospho-alpha-D-ribose 1-diphosphate	False	
ps160_c_	phosphatidylserine (dihexadecanoyl, n-C16:0)	False	
ps161_c_	phosphatidylserine (dihexadec-9-enoyl, n-C16:1)	False	
pser_L_c_	O-Phospho-L-serine	False	
pyam5p_c_	Pyridoxamine 5'-phosphate	False	
pydx5p_c_	Pyridoxal 5'-phosphate	False	
pyr_c_	Pyruvate	False	
pyr_e_	Pyruvate	True	
pyr_p_	Pyruvate	False	
q8_c_	Ubiquinone-8	False	
q8h2_c_	Ubiquinol-8	False	
quln_c_	Quinolinate	False	
r1p_c_	alpha-D-Ribose 1-phosphate	False	
r5p_c_	alpha-D-Ribose 5-phosphate	False	
rhcys_c_	S-Ribosyl-L-homocysteine	False	
ribflv_c_	Riboflavin	False	
ru5p_D_c_	D-Ribulose 5-phosphate	False	
s7p_c_	Sedoheptulose 7-phosphate	False	
scl_c_	sirohydrochlorin	False	
ser_L_c_	L-Serine	False	
seramp_c_	L-seryl-AMP	False	
sheme_c_	Siroheme	False	
skm5p_c_	Shikimate 5-phosphate	False	
skm_c_	Shikimate	False	
sl26da_c_	N-Succinyl-LL-2,6-diaminoheptanedioate	False	
sl2a6o_c_	N-Succinyl-2-L-amino-6-oxoheptanedioate	False	
so3_c_	Sulfite	False	
so4_c_	Sulfate	False	
so4_e_	Sulfate	True	
so4_p_	Sulfate	False	
succ_c_	Succinate	False	
succoa_c_	Succinyl-CoA	False	
suchms_c_	O-Succinyl-L-homoserine	False	
t3c5ddeceACP_c_	trans-3-cis-5-dodecenoyl-[acyl-carrier protein]	False	
t3c7mrseACP_c_	trans-3-cis-7-myristoleoyl-[acyl-carrier protein]	False	
t3c9palmeACP_c_	trans-3-cis-9-palmitoleoyl-[acyl-carrier protein]	False	
tddec2eACP_c_	trans-Dodec-2-enoyl-[acyl-carrier protein]	False	
tdeACP_c_	cis-tetradec-7-enoyl-[acyl-carrier protein] (n-C14:1)	False	
tdec2eACP_c_	trans-Dec-2-enoyl-[acyl-carrier protein]	False	
thdp_c_	2,3,4,5-Tetrahydrodipicolinate	False	
thex2eACP_c_	trans-Hex-2-enoyl-[acyl-carrier protein]	False	
thf_c_	5,6,7,8-Tetrahydrofolate	False	
thmmp_c_	Thiamin monophosphate	False	
thmpp_c_	Thiamine diphosphate	False	
thr_L_c_	L-Threonine	False	
tmrs2eACP_c_	trans-Tetradec-2-enoyl-[acyl-carrier protein]	False	
toct2eACP_c_	trans-Oct-2-enoyl-[acyl-carrier protein]	False	
tpalm2eACP_c_	trans-Hexadec-2-enoyl-[acyl-carrier protein]	False	
trdox_c_	Oxidized thioredoxin	False	
trdrd_c_	Reduced thioredoxin	False	
trnaglu_c_	tRNA (Glu)	False	
trp_L_c_	L-Tryptophan	False	
tyr_L_c_	L-Tyrosine	False	
u23ga_c_	UDP-2,3-bis(3-hydroxytetradecanoyl)glucosamine	False	
u3aga_c_	UDP-3-O-(3-hydroxytetradecanoyl)-N-acetylglucosamine	False	
u3hga_c_	UDP-3-O-(3-hydroxytetradecanoyl)-D-glucosamine	False	
uLa4fn_c_	undecaprenyl phosphate-4-amino-4-formyl-L-arabinose	False	
uLa4n_c_	undecaprenyl phosphate-4-amino-4-deoxy-L-arabinose	False	
uLa4n_p_	undecaprenyl phosphate-4-amino-4-deoxy-L-arabinose	False	
uaagmda_c_	Undecaprenyl-diphospho-N-acetylmuramoyl-(N-acetylglucosamine)-L-ala-D-glu-meso-2,6-diaminopimeloyl-D-ala-D-ala	False	
uaccg_c_	UDP-N-acetyl-3-O-(1-carboxyvinyl)-D-glucosamine	False	
uacgam_c_	UDP-N-acetyl-D-glucosamine	False	
uagmda_c_	Undecaprenyl-diphospho-N-acetylmuramoyl-L-alanyl-D-glutamyl-meso-2,6-diaminopimeloyl-D-alanyl-D-alanine	False	
uama_c_	UDP-N-acetylmuramoyl-L-alanine	False	
uamag_c_	UDP-N-acetylmuramoyl-L-alanyl-D-glutamate	False	
uamr_c_	UDP-N-acetylmuramate	False	
udcpdp_c_	Undecaprenyl diphosphate	False	
udcpp_c_	Undecaprenyl phosphate	False	
udcpp_p_	Undecaprenyl phosphate	False	
udpLa4fn_c_	uridine 5''-diphospho-{beta}-4-deoxy-4-formamido-L-arabinose	False	
udpLa4n_c_	uridine 5''-diphospho-{beta}-4-deoxy-4-amino-L-arabinose	False	
udpLa4o_c_	UDP-4-keto-pyranose	False	
udp_c_	UDP	False	
udpg_c_	UDPglucose	False	
udpglcur_c_	UDP-D-glucuronate	False	
ugmd_c_	UDP-N-acetylmuramoyl-L-alanyl-D-gamma-glutamyl-meso-2,6-diaminopimelate	False	
ugmda_c_	UDP-N-acetylmuramoyl-L-alanyl-D-glutamyl-meso-2,6-diaminopimeloyl-D-alanyl-D-alanine	False	
ump_c_	UMP	False	
uppg3_c_	Uroporphyrinogen III	False	
ura_c_	Uracil	False	
uri_c_	Uridine	False	
utp_c_	UTP	False	
val_L_c_	L-Valine	False	
xmp_c_	Xanthosine 5'-phosphate	False	
xu5p_D_c_	D-Xylulose 5-phosphate	False	
zn2_c_	Zinc	False	
zn2_e_	Zinc	True	
zn2_p_	Zinc	False	
